Name	title	coding
t3_jzsg5c	Biden to pick Janet Yellen for Treasury secretary	transition
t3_jzsfv2	Obama calls Trump era an 'anomaly' in Canada-U.S. relations	dissatisfaction
t3_jzsfqc	First Latino tapped to head DHS signals shift from Trump's hard-line immigration policies	transition
t3_jzsfbe	Trump attorney in Wisconsin argues absentee votes should be thrown out - including his own	lawsuit
t3_jzser3	"AP: Trump won 3.1M votes in Ohio, a new state record"	vote
t3_jzseje	National Security Experts Urge Republicans To Demand Trump Concede The Election	lawsuit
t3_jzscgu	"GM Abandons Trump Admin in Lawsuit Over California Emission Standards, a Sign Automaker Knows Biden Will Be Taking Over"	economy_climate
t3_jzsbmo	Michigan certifies Biden win; a setback for Trump challenge	lawsuit
t3_jzsb0q	Michigan's state board certifies Biden's win	lawsuit
t3_jzs7ix	G.M. Drops Its Support for Trump Climate Rollbacks and Aligns With Biden	economy_climate
t3_jzs7bo	Michael J Fox compares Trump to Back to the Future villain: ‘Biff is president’.	dissatisfaction
t3_jzs6yd	PolitiFact - Trump's Pants on Fire claim about votes exceeding voters in swing states	lawsuit
t3_jzs5wi	"Michigan board votes to certify the state’s election results, dealing Trump another blow"	lawsuit
t3_jzs4qi	Detroit had more vote errors in 2016 when Trump won Michigan by a narrow margin. He didn’t object then.	vote
t3_jzs2sh	Carl Bernstein says 21 Republican members of U.S. Senate have expressed disdain for Trump	dissatisfaction
t3_jzs1zq	How Trump's fundraising could benefit his post-White House political life	transition
t3_jzs0fi	Michigan Certifies Joe Biden's Election Victory	lawsuit
t3_jzs06l	"Michigan certifies Joe Biden's win despite Trump's GOP overtures | The Board of State Canvassers, which has two Republicans and two Democrats, confirmed the results on a 3-0 vote with one abstention"	lawsuit
t3_jzrzv8	Rush Limbaugh Knocks Trump's Lawyers For Not Providing Voter Fraud Proof	lawsuit
t3_jzrztf	CEOs Urge Trump To Concede: 'Not A Moment To Waste' In Fighting COVID-19	covid
t3_jzrye4	Michigan votes to certify Biden's win over Trump	lawsuit
t3_jzrxcw	Biden's pick for top spy brings experience from CIA and White House	transition
t3_jzrxcf	Trump set to veto defense bill over renaming bases honoring Confederate leaders	policy
t3_jzrwp5	GSA offers to brief lawmakers on Biden transition next week; Emily Murphy won't host	transition
t3_jzrwkf	Trump’s vote fraud claims draw continued scrutiny from Twitter	lawsuit
t3_jzrwf7	Indiana senators Braun and Young deny report they privately hold Trump in contempt	dissatisfaction
t3_jzrwc2	Pennsylvania Supreme Court Kills Trump Bid to Disqualify Ballots	lawsuit
t3_jzrvao	Michigan votes to certify Biden's win over Trump	lawsuit
t3_jzrv9z	"Mnuchin to End Key Fed Emergency Programs, Limiting Biden"	policy
t3_jzrv7q	Trump's top election lawyer in Wisconsin says he and his wife voted illegally in the campaign's latest legal argument	lawsuit
t3_jzrv19	Georgia sets timeline for Trump-requested recount	vote
t3_jzruwz	General Motors’ parting shot at Trump bodes well for the Biden presidency	dissatisfaction
t3_jzruw3	Trump loses yet again as Michigan's state board certifies Biden's win	lawsuit
t3_jzrtx4	Biden to nominate Janet Yellen as first female Treasury secretary: report	transition
t3_jzrtop	"Bipartisan Michigan election board certifies Biden’s win on 154,000-vote margin"	vote
t3_jzrtio	Biden Picks Foreign Service Veteran Linda Thomas-Greenfield For U.N. Ambassador	transition
t3_jzrspx	'Special jeopardy': 100 former Republican national security officials warn Trump must allow transition	dissatisfaction
t3_jzrr0v	Analysis: Biden's pick for U.N. envoy will find waning American influence	policy
t3_jzrqsw	Joe Biden Picks Pro-Migration Swamper for Top DHS Slot	transition
t3_jzrq5g	"Michigan election board votes to certify Biden win, dealing blow to Trump effort"	lawsuit
t3_jzrpuy	Michigan's state board certifies Biden's win	lawsuit
t3_jzrpbc	Trump campaign to ask appeals court to halt Biden win in Pennsylvania	lawsuit
t3_jzrp6i	Can Democrats Win Georgia Without Trump on the Ticket?	vote
t3_jzrnx5	Michigan certifies Biden victory in another blow to Trump	lawsuit
t3_jzrmfo	"Who is Sidney Powell, the lawyer the Trump campaign is now distancing itself from?"	lawsuit
t3_jzrmdg	Michigan certifies Biden win despite Trump's GOP overtures	lawsuit
t3_jzrmc0	"Trump’s Ridiculous, Sloppy Coup Attempt Just Face-Planted in Michigan"	lawsuit
t3_jzrlnt	Michigan certifies Biden win despite Trump's GOP overtures	lawsuit
t3_jzrlc7	Maine certifies Biden’s victory in the state’s election	lawsuit
t3_jzrl9q	Michigan's state board certifies Biden's win	lawsuit
t3_jzrl06	Chris Christie calls Trump's legal team a 'national embarrassment'	dissatisfaction
t3_jzrkeu	Michigan Certifies Election Results Showing Biden Victory	vote
t3_jzrk2b	Michigan board certifies Biden's victory in the state	vote
t3_jzrjiy	Michigan board of state canvassers certifies results of November 3 U.S. presidential election for Democrat Biden	vote
t3_jzrjet	"Michigan election board certifies 154,000-vote victory for Joe Biden, another setback in Trump’s effort to overturn election results"	vote
t3_jzrj8r	Michigan's state board certifies Biden's win	vote
t3_jzri76	Michigan board of state canvassers certifies results of November 3 U.S. presidential election for Democrat Biden	vote
t3_jzrgvq	Biden Team Highlights Cybersecurity Focus With First Cabinet Picks	transition
t3_jzrguj	Michigan certifies Biden win despite Trump's GOP overtures	vote
t3_jzrfd8	Michigan's state board certifies Biden's win	vote
t3_jzrfd5	"Michigan board votes to certify the state’s election results, dealing Trump another blow"	lawsuit
t3_jzreko	Michigan's state board certifies Biden's win	vote
t3_jzrdys	Schisms emerging between Far-Right Fox News and soon-to-be former President Donald Trump	dissatisfaction
t3_jzrd9l	Progressives urge Biden away from including Obama energy secretary in administration	dissatisfaction
t3_jzrd1u	Biden chooses former Fed Chair Janet Yellen to be Treasury secretary	transition
t3_jzrcyi	"President-elect Joe Biden's administration will include the first female to serve as VP, Treasury Secretary, Defense Secretary and Director of National Intelligence in U.S. history"	transition
t3_jzrcrn	Michigan certifies Joe's Biden win despite Trump's GOP overtures	vote
t3_jzrcjf	"Michigan election board votes to certify Biden win, dealing blow to Trump effort"	vote
t3_jzrchd	"Michigan board votes to certify the state’s election results, dealing Trump another blow"	vote
t3_jzrbwa	"Michigan election board votes to certify Biden win, dealing blow to Trump effort"	vote
t3_jzrbs8	Former Fed Chair Janet Yellen reportedly Biden pick for Treasury Secretary	transition
t3_jzrbow	Election 2020 live updates: Michigan certifies election results finding Biden the winner	vote
t3_jzrbkx	How Trump's fundraising could benefit his post-White House political life	transition
t3_jzrbbr	Michigan certifies Biden win despite Trump's GOP overtures	vote
t3_jzrauu	Election 2020 live updates: Michigan certifies election results finding Biden the winner	vote
t3_jzratd	"Michigan board votes to certify the state’s election results, dealing Trump another blow"	vote
t3_jzrar7	"Michigan board votes to certify the state’s election results, dealing Trump another blow"	vote
t3_jzra8r	"In blow to Trump, Michigan canvassing board certifies election results"	lawsuit
t3_jzr9x7	"Michigan election board certifies 154,000-vote victory for Joe Biden, another setback in Trump’s effort to overturn election results"	vote
t3_jzr8px	Michigan certifies Biden win despite Trump's GOP overtures	vote
t3_jzr8dl	Michigan certifies Biden win despite Trump's GOP overtures	vote
t3_jzr8aw	Michigan election board certifies Biden win	vote
t3_jzr88b	"Michigan election board certifies 154,000-vote victory for Joe Biden, another setback in Trump’s effort to overturn election results"	vote
t3_jzr85t	"Michigan election board votes to certify Biden win, dealing blow to Trump effort"	vote
t3_jzr803	Biden plans to nominate Janet Yellen for Treasury secretary	transition
t3_jzr7w5	Trump campaign suffers new court loss in attempt to block Biden's win in Pennsylvania	lawsuit
t3_jzr7kz	Michigan Certifies Joe Biden's Election Victory	vote
t3_jzr77v	"Michigan board votes to certify the state’s election results, dealing Trump another blow"	vote
t3_jzr751	"Michigan board votes to certify the state’s election results, dealing Trump another blow"	vote
t3_jzr71y	Trump campaign to ask appeals court to halt Biden win in Pennsylvania	lawsuit
t3_jzr71p	Trump's top election lawyer in Wisconsin says he and his wife voted illegally in the campaign's latest legal argument	lawsuit
t3_jzr6vb	Michigan's Board Of Canvassers Certified Biden's Win In A Big Loss For Trump's Desperate Bid To Overturn The Election	vote
t3_jzr6u0	Michigan Certifies Joe Biden's Election Victory	vote
t3_jzr64x	"Alejandro Mayorkas, Biden's Pick For DHS Head, Would Be 1st Latino In Post"	transition
t3_jzr5yp	Michigan Certifies Joe Biden's Election Victory	vote
t3_jzr5u4	"Biden picks John Kerry as climate czar, Janet Yellen as Treasury secretary"	transition
t3_jzr5f1	Michigan Election Board Certifies Victory for Biden	vote
t3_jzr4ue	Michigan Election Board Certifies Victory for Biden	vote
t3_jzr4r9	Georgia sets timeline for Trump-requested recount	lawsuit
t3_jzr4dw	"Michigan elections board certifies results from presidential election, sealing Biden’s win in state"	vote
t3_jzr46b	Biden Picks Janet Yellen To Be Treasury Secretary	transition
t3_jzr438	"From 'Alarming Red Flag' to 'Something We Can Work With,' Campaigners Respond to Kerry as Biden Climate Envoy"	transition
t3_jzqzld	"Trump campaign forces Georgia taxpayers to pay for second recount after first one confirms its loss. A hand recount of nearly 5 million votes confirmed Biden's win, but Team Trump wants to milk taxpayers even more"	lawsuit
t3_jzqz78	"Trump will go, but Trumpism will remain"	dissatisfaction
t3_jzqwc4	"Biden to choose ex-Fed chair Yellen as first woman Treasury secretary, allies say"	transition
t3_jzqvlj	Biden Choosing Janet Yellen for Treasury secretary	transition
t3_jzquzq	"GOP senator: No indication of widespread voting irregularities, window for Trump challenges is 'closing'"	lawsuit
t3_jzquid	Former Fed Chair Janet Yellen reportedly Biden pick for Treasury Secretary	transition
t3_jzqsc8	"Americans Want Biden to Prioritize Unity Over Progressive Agenda, Survey Finds"	policy
t3_jzqrf3	Bernstein names 21 Republican senators who privately expressed contempt for Trump	dissatisfaction
t3_jzqp20	Trump-Appointed Judges Find Conversion Therapy Bans Unconstitutional	policy
t3_jzqn1f	"Trump fears Giuliani, other lawyers in Biden vote challenge are 'fools that are making him look bad'"	lawsuit
t3_jzqk4b	Secret Service members asked about protecting soon-to-be-former president Trump full time in Florida: Sources | Agents in Trump's detail have been asked about relocating to West Palm Beach.	transition
t3_jzqj8z	"Trump Fears Giuliani, Other Lawyers in Biden Vote Challenge Are ‘Fools That Are Making Him Look Bad’"	lawsuit
t3_jzqiqp	Biden Choses Alejandro Mayorkas As His Secretary Of Homeland Security	transition
t3_jzqioi	Poll: Majority say Trump should concede	transition
t3_jzqh7h	Trump campaign suffers new court loss in attempt to block Biden's win in Pennsylvania	lawsuit
t3_jzqg3e	Trump campaign suffers new court loss in attempt to block Biden’s win in Pennsylvania	lawsuit
t3_jzqf5t	"Republican Congressman Says GOP 'Embarrassing,' Calls on Party to 'Denounce' Trump's 'Conspiracy Theories'"	dissatisfaction
t3_jzqc18	Biden chooses former Fed Chair Janet Yellen to be Treasury secretary	transition
t3_jzqbl0	"Republican Congressman Says GOP 'Embarrassing,' Calls on Party to 'Denounce' Trump's 'Conspiracy Theories'"	dissatisfaction
t3_jzq9v3	Bernstein names 21 Republican senators who privately expressed contempt for Trump | Donald Trump | The Guardian	dissatisfaction
t3_jzq9tv	John Kerry named as Joe Biden's special climate envoy | US news	transition
t3_jzq7ps	Joe Biden expected to announce Janet Yellen as next treasury secretary pick	transition
t3_jzq7pa	Biden’s pick for Treasury Secretary will be Janet Yellen	transition
t3_jzq7ab	"Trump Supporters in Georgia Threaten to Destroy GOP, Boycott Runoff Elections"	dissatisfaction
t3_jzq725	Biden chooses former Fed Chair Janet Yellen to be Treasury secretary	transition
t3_jzq5ss	Biden’s pick for Treasury Secretary will be Janet Yellen	transition
t3_jzq543	Committee Chairs Insist on GSA Briefing Tomorrow on Ongoing Refusal to Grant Biden-Harris Team Access to Transition Resources	transition
t3_jzq2dw	Poll: Majority say Trump should concede	dissatisfaction
t3_jzq0ke	Biden To Nominate Former Fed Chair Janet Yellen For Treasury Secretary	transition
t3_jzq0dh	Biden’s Europe challenge: Repair tattered transatlantic ties | Four years of Donald Trump have done serious damage to mutual trust.	policy
t3_jzpyzb	"Behind the scenes, Trump frustrated with his legal team's maneuvers"	dissatisfaction
t3_jzpy16	"On Trump, GOP's silence 'can't be excused and won't be forgiven' — For the first time, a corrupt US leader is trying to cling to power through autocratic means. Let history note who lacked the patriotism to speak up."	dissatisfaction
t3_jzpxxu	Biden taps Blinken to reshape U.S. foreign policy in post-Trump era	policy
t3_jzpwxq	"Trump Is Blowing Up the Georgia GOP—and It Couldn’t Happen at a Better Time: His complaints about a “stolen” election have state Republicans in a circular firing squad, threatening their chances to win two Senate seats in January."	dissatisfaction
t3_jzpvd8	Trump's bizarro-world 'elite strike force' legal challenge is about to implode	dissatisfaction
t3_jzpvbh	Rush Limbaugh criticizes Trump legal team for promising 'bombshells' and failing to deliver	dissatisfaction
t3_jzpuu9	Election officials are facing death threats in key swing states where Trump is trying to overturn the results of the 2020 presidential race	dissatisfaction
t3_jzpt5h	"Biden Expected to Pick Janet Yellen, Former Fed Chair, as Treasury Secretary"	transition
t3_jzprxe	Trump’s Absurd ‘You Did It First’ Argument for Stealing the Election	dissatisfaction
t3_jzpr6u	Trump Wants 3rd Circuit to Halt Pennsylvania Certification	lawsuit
t3_jzpowr	Let’s hear it for the judges for dismissing Trump’s lawsuits	lawsuit
t3_jzpo97	"Biden taps first Latino to head DHS, first woman to lead intelligence"	transition
t3_jzpmd7	"Biden Expected to Pick Janet Yellen, Former Fed Chair, as Treasury Secretary"	transition
t3_jzpllg	The Already Useless Trump Kids Are About to Get Even More So	dissatisfaction
t3_jzpko2	Biden to pick ex-Fed chair Yellen for Treasury secretary: WSJ	transition
t3_jzpk7a	A major Trump donor’s company got a 3 percent government-backed pandemic loan. It sells title loans at a 350 percent annual rate.	dissatisfaction
t3_jzpjm8	"What if Trump won’t leave the White House? A hostage negotiator, an animal-control officer, and a toddler whisperer have advice"	dissatisfaction
t3_jzpilm	164 business leaders urge Trump to begin presidential transition for the sake of the country	dissatisfaction
t3_jzphue	"GOP senator, business leaders urge prompt Biden transition"	transition
t3_jzpfqd	Pro-Trump Attorney Urges Republicans Not to Vote in Georgia Runoff	lawsuit
t3_jzpff1	Corporate America is ready for a Biden presidency	transition
t3_jzpfan	Biden chooses former Fed Chair Janet Yellen to be Treasury secretary	transition
t3_jzpf1h	GM flips to California's side in pollution fight with Trump	dissatisfaction
t3_jzpexr	"What if Trump won’t leave the White House? A hostage negotiator, an animal-control officer, and a toddler whisperer have advice | Give him a five-minute warning, use food as a lure, remind him he has something to live for."	dissatisfaction
t3_jzpeei	Trump Is Blowing Up the Georgia GOP—and It Couldn’t Happen at a Better Time	vote
t3_jzpddc	Land conservation plan stirs fight over Trump restrictions	policy
t3_jzpd2k	Factbox: The Biden Cabinet - President-elect builds his foreign policy team	policy
t3_jzpbvs	"Biden chooses former Fed Chair Janet Yellen to be Treasury secretary, report says"	transition
t3_jzpbaz	"General Motors Reverses Course, Spurns Trump-Backed California Emissions Lawsuit"	dissatisfaction
t3_jzp967	"General Motors Aligns With Biden, Pulls Out of Lawsuit Supporting Trump"	dissatisfaction
t3_jzp95d	"Despite Trump’s prod, Mich. to consider certifying Biden win"	vote
t3_jzp8jd	"Alejandro Mayorkas, Biden's Pick For DHS Head, Would Be First Latino In Post"	transition
t3_jzp787	Unpacking Joe Biden's decision to tap John Kerry as his climate envoy	transition
t3_jzp6x0	"Marjorie Taylor Greene ""solidly convinced"" Trump won Georgia despite state certifying Biden's win"	lawsuit
t3_jzp5u8	"Biden Brain Trust: Forget the Billionaires, Guillotine the Corporations"	dissatisfaction
t3_jzp4fh	Is Trump Selling Tickets to His 2021 Inauguration?	vote
t3_jzp2ts	Joe Biden nominates first woman to lead intelligence and first Latino to head homeland security	transition
t3_jzozd1	"Why the Trump campaign’s big legal flameout in Pennsylvania seems like a turning point, even for Republicans"	lawsuit
t3_jzoyr6	"Trump fears Giuliani, other lawyers in Biden vote challenge are 'fools that are making him look bad'"	dissatisfaction
t3_jzoykr	"Trump's on his way out, but leaves a lasting legacy: The right's open embrace of terrorism"	dissatisfaction
t3_jzoxch	What Donald Trump and Dick Cheney Got Wrong About America	dissatisfaction
t3_jzos3p	It’s Time To Consider Sanctions for Trump’s Legal Team	dissatisfaction
t3_jzorp7	Rush Limbaugh: Trump Needs to Hold Rallies in Georgia	vote
t3_jzorhc	"Trump fears Giuliani, other lawyers in Biden vote challenge are ‘fools that are making him look bad’"	dissatisfaction
t3_jzopwy	Why is Joe Biden considering this man to help fight the climate crisis?	transition
t3_jzopkn	Biden taps Alejandro Mayorkas as first immigrant to lead Homeland Security	transition
t3_jzopfi	EU's Michel invites Biden to 'rebuild' trans-Atlantic alliance	policy
t3_jzop8u	Why The Oil Industry Doesn't Fear Biden	economy_climate
t3_jzoon5	Team Trump Fired QAnon Lawyer Sidney Powell But She's Tweeting Through It	lawsuit	eh
t3_jzonsl	Former Defense Secretary Jim Mattis says Biden should toss all of Trump's 'America First' policies	policy
t3_jzon8h	"Plagued by COVID outbreaks, the meatpacking industry could be forced to change under Biden"	economy_climate
t3_jzomjx	"Drip by drip, U.S. Republicans slowly break from Trump election claims"	lawsuit
t3_jzok9t	Bernstein names 21 Republican senators who privately expressed contempt for Trump	dissatisfaction
t3_jzogjj	John Kerry to join Biden administration as National Security Council official dedicated to climate change	transition
t3_jzofom	Biden moves forward as GOP breaks with Trump rise	transition
t3_jzoe8p	A big inauguration crowd? Biden’s chief of staff expects ‘scaled-down’ event	transition
t3_jzodbz	Top Biden aide Ricchetti will be a White House liaison for Congress and business community	transition
t3_jzobu4	"Behind the scenes, Trump frustrated with his legal team's maneuvers"	dissatisfaction
t3_jzoao6	Biden to name first female head of National Intelligence	transition
t3_jzoam2	Reality Forecloses on the Trump Presidency | A fading campaign collapses under the weight of finally having to back up big talk with actual substance.	dissatisfaction
t3_jzo8pn	GM flips to California's side in pollution fight with Trump	dissatisfaction
t3_jzo75x	GM hits reverse on Trump effort to bar California emissions rules	economy_climate
t3_jzo73a	G.M. Drops Its Support for Trump Climate Rollbacks and Aligns With Biden	dissatisfaction
t3_jzo5py	G.M. Drops Its Support for Trump Climate Rollbacks and Aligns With Biden	dissatisfaction
t3_jzo58j	Biden picks Cuban-American lawyer Mayorkas as U.S. homeland security chief	transition
t3_jzo4ys	"To Prevent 'Active Sabotage' of His Agenda, Biden Urged to Clean House of Trump Loyalists on Day One"	policy
t3_jzo44d	Two years ago this week Trump was mocking a turkey for refusing to concede an election	lawsuit
t3_jzo3qg	Clip of Ted Cruz Saying Democrats Would Say COVID 'Magically Better' Week After Biden Wins Resurfaces	covid
t3_jzo3o9	How Trump's destructive behavior emboldens authoritarian leaders abroad	dissatisfaction
t3_jzo04h	Trump campaign takes Pennsylvania election fight to federal appeals court	lawsuit
t3_jznz36	Did Trump Pardon a Turkey That 'Refused To Concede' an Election?	dissatisfaction
t3_jznyip	Message to Joe Biden: No Torturers in the Next Cabinet. Biden and Harris must eschew anyone complicit in torture or who frustrated oversight.	transition
t3_jzny0i	"Pennsylvania Republicans Voted Against Certifying Vote in County Trump Won by 22,000"	vote
t3_jznx2m	Biden signals shift from Trump with national security picks	policy
t3_jzntq8	GM flips to California’s side in emissions lawsuit against Trump admin	economy_climate
t3_jznr6e	"Trump 2024? Two-thirds of GOP voters want him to run for president again, poll says"	vote
t3_jznqim	"Explainer: Despite Trump claims, voter fraud is extremely rare. Here is how U.S. states keep it that way"	dissatisfaction
t3_jznq3n	Clip of Ted Cruz Saying Democrats Would Say COVID 'Magically Better' Week After Biden Wins Resurfaces	covid
t3_jznpy5	Trump set on veto of defense bill over renaming bases honoring Confederates	policy
t3_jznkwh	"John Kerry, Alejandro Mayorkas, Avril Haines among Joe Biden’s cabinet picks"	transition
t3_jznjcm	"Post-Trump, his party and his favorite network have to figure out their relationship with reality"	dissatisfaction
t3_jzniv7	"Biden to name Kerry as U.S. climate czar, emphasizing diplomacy's role in the fight"	transition
t3_jznd9v	Biden Picks Cuban-American Lawyer Mayorkas as U.S. Homeland Security Chief	transition
t3_jznb23	How Trump placed a ticking time bomb at the center of our system	dissatisfaction
t3_jzna59	"New Trump rule may require some African tourists to pay up to $15,000 in bonds"	policy
t3_jzn4mo	"Despite Trump’s prod, Mich. to consider certifying Biden win"	vote
t3_jzn3cr	Biden Taps John Kerry For New National Security Role Focused On The Climate Crisis	economy_climate
t3_jzn0c8	"Biden taps John Kerry as Special Presidential Envoy for Climate, marking the first time the NSC will have an official dedicated to climate change"	economy_climate
t3_jzmvt2	Biden's inner circle get key cabinet posts as John Kerry named climate tsar	transition
t3_jzmvi7	"Trump's on his way out, but leaves a lasting legacy: The right's open embrace of terrorism. How did the Kenosha shooter post $2 million in bail? Because conservatives are normalizing right-wing terrorism"	dissatisfaction
t3_jzmus9	"Donald Trump’s Bid to Steal the Election Hinges on a Shameless Homophobe Who Once Called Him a Lying, Idiotic Bully"	dissatisfaction
t3_jzmubj	"Joe Biden Names Picks for Secretary of State, Homeland Security Chief, Director of National Intelligence"	transition
t3_jzmtno	Tucker Carlson was attacked by Trump supporters for questioning the outlandish claims of the president's lawyer Sidney Powell before she was fired	dissatisfaction
t3_jzmsfq	Biden to name John Kerry as presidential climate envoy	transition
