Name	title	coding
t3_k0fwz8	6000 False Biden votes in AZ discovered.	lawsuit
t3_k0flpb	Hunter Biden Arrives At White House Dressed As Turkey In Hopes Of Being Pardoned By Trump	transition
t3_k0flki	Mueller Probe's Andrew Weissmann Wants Biden DOJ to Prosecute Trump	lawsuit
t3_k0flhj	Biden’s Gun-Registration Scheme Would Cost Firearm Owners Billions — If It Passed Congress and Americans Complied	economy_climate
t3_k0fhm7	The Biden Popular Front Is Doomed to Unravel	dissatisfaction
t3_k0fcyi	Poll: One In Six Biden Voters Would Have Changed Their Vote If They Had Known About Scandals Suppressed By Media	vote
t3_k0f9nk	Where are the Republican Politicians? Have they Deserted Trump?	dissatisfaction
t3_k0ao2g	Biden’s win in Nevada certified by Nevada Supreme Court	lawsuit
t3_k0eyot	"Joseph Nye: ""Trump deserves credit for pushing back on China's abusive trade practices, but it would have been better if we worked with our allies to isolate China. Also, his trade deal has been costly for Americans without changing the trade imbalance or addressing technological issues."""	policy
t3_k0ex0g	Dominion Executive: Trump is not going to win. I made f***ing sure of that.	dissatisfaction
t3_k0eqm4	After joining Burisma, Hunter Biden requested meetings with Antony Blinken, Biden's Pick for Secretary of State	transition
t3_k0elxb	The Fourth Estate: Andrea Mitchell reports that a Biden administration isn't going to be political	transition
t3_k0ei4s	Dan Bongino hints at potential run for president in 2024 if Larry Hogan runs and no Trump does	vote
t3_k0e90v	Secretary of state pick Antony Blinken met twice with Hunter Biden	transition
t3_k0e8yx	Poll Shows Media Censorship Cheated Voters of Vital Info, Robbed Trump of Second Term	dissatisfaction
t3_k0dwph	Mattis says he hopes Joe Biden takes 'America First' out of national security strategy	transition
t3_k0dv2v	'WJ Live': The Viral Memo Changing the Trump Legal Strategy	lawsuit
t3_k0dlm3	Pennsylvania, Nevada certify election results for Biden despite Trump legal challenges	lawsuit
t3_k0ddev	Nolte: Only 3% of Trump Voters Believe Joe Biden Is Legitimate Winner	vote
t3_k0cwtc	Google Plots to Use the Biden Administration to Avoid Accountability	dissatisfaction
t3_k0ccte	Trump: Voters are '100% correct' that 2020 'election was stolen' -- Jenna Ellis: 'Media chatter of Joe Biden picking his cabinet is like fantasy football'	dissatisfaction
t3_k0cbf4	Rashida Tlaib accused of anti-Semitism for reaction to Biden's Jewish Sec of State nominee	discrimination
t3_k0cb1h	Hawley 2024? Missouri Republican could be ‘Trump 2.0,’ say conservative supporters	vote
t3_k0c7j8	Chris Evans, Zach Braff Want A List Of ‘Trump Enablers’	vote
t3_k0bxsq	From revolution to restoration: Biden picks Blinken, Yellen, Kerry for plum posts	transition
t3_k0bp1y	Election Aftermath: Either Or -- It is down to an “either or” situation: either President Trump prevails in his lawsuits and multiple constitutional paths to reelection, or Joe Biden and the Democrats succeed in stealing the election.	dissatisfaction
t3_k0b0kz	Trump vows he’ll ‘never concede’ despite administration starting transition move	transition
t3_k0azmb	Computer Repair Shop Involved in Hunter Biden Laptop Scandal Shuttered	dissatisfaction
t3_k0ajsq	Joe Biden Central-Planning Ambitions Dangerous	dissatisfaction
t3_k0ah7t	"Ted Cruz Hits AOC for Criticizing Senate Recess. ""AOC seems not to know there are Democrats in the Senate. Or that Joe Biden (also a Dem) is publicly calling on Senate Dems to continue filibustering COVID relief because he thinks it will help them win Georgia.”"	covid
t3_k0a51f	BREAKING: New poll shows 17 percent of Biden voters would have avoided picking Biden if they knew of stories the media suppressed:	vote
t3_k08cy8	Trump campaign continues to fight as more evidence of voter fraud emerges	lawsuit
t3_k089yi	'Malevolent travelers' coming if Trump's travel ban killed -- Biden has promised to eliminate executive order on 'Day 1'	dissatisfaction
t3_k087mh	In picking John Kerry as his cabinet-level “climate czar,” Joe Biden is signaling strong support for Rep. Alexandria Ocasio-Cortez’s costly Green New Deal. Rumors are circulating that AOC is being considered for EPA administrator or elsewhere in the administration.	economy_climate
t3_k085p9	Rubio derides Biden's foreign policy team: 'Polite and orderly caretakers of America's decline'	dissatisfaction
t3_k084zn	FNC's Laura Ingraham: 'I Would Be Lying to You' if I Said There Was an 'Excellent' Chance SCOTUS Delivers Victory to Trump	transition
t3_k082id	Biden's Pick For National Security Adviser Is A Steele Dossier Truther	transition
t3_k080zd	FBI Buried Hunter Biden Laptop: It’s unlikely there was ever any investigation at all.	dissatisfaction
t3_k07tg5	Sidney Powell responds after Trump campaign says she is not part of legal team: '#KrakenOnSteroids'	lawsuit
t3_k07qob	"Patrick Buchanan: ""What Trump Will Leave in Biden's Inbox"""	transition
t3_k05c36	War and more war coming with Biden’s Sec. of State Blinken	dissatisfaction
t3_k06ko7	Biden’s Student Loan Bailouts: Bad Economics, A Regressive Tax, And A Moral Hazard	economy_climate
t3_k06k0b	Two of Joe Biden's national security picks have ties to past scandals	dissatisfaction
t3_k06hmi	Graham warns Biden, Pelosi and Schumer would form 'trifecta from hell' if Democrats take Senate	dissatisfaction
t3_k06f5y	2020 has been miserable in so many ways. Well here's an uplifting story guaranteed to make you smile and feel better. It's a heartwarming story of two deceased voters who made their voices heard for biden.	lawsuit
t3_k05eu0	Trump lawsuit confuses Michigan and Minnesota locations in affidavit claiming voter fraud	lawsuit
t3_k056dg	John Brennan's breathless &amp;amp; dramatic thread bidding farewell to the president is met with calls for Trump to 'declassify everything'	transition
t3_k04poa	Fearing break-up, Facebook plans to woo Joe Biden with new vaccine and climate change PR	transition
t3_k04g30	NY Mag Scientifically Proves Biden Supporters Are Racist	discrimination
t3_k04ftf	Study: Biden won thousands of illegal votes by noncitizens	lawsuit
t3_k03aro	Study: Biden received thousands of non-citizen illegal votes in battleground states	lawsuit
t3_k02wgo	Maxine Waters Pushes for Investigation of 'Criminal' Trump To 'Send a Message Across the World'	lawsuit
t3_k01ja2	Alan Dershowitz Says Trump Still Has ‘Two or Three Constitutional Paths’ To A 2020 Victory – But He Hasn’t Seen The Evidence To Overturn	transition
t3_k005l3	"President Trump: ""We are moving full speed ahead. Will never concede to fake ballots &amp; 'Dominion'"""	transition
t3_jzzay5	Trump Won't Budge From Veto Threat Over Renaming Bases Honoring Confederates	policy
t3_jzyvw1	Tucker Carlson: Yes, the election was rigged for Joe Biden. Here's how	lawsuit
t3_jzyv4s	Jenna Ellis insulted Trump and his supporters in 2016. The RINOs are on the inside.	dissatisfaction
t3_jzyhtm	Biden climate envoy John Kerry is a lifelong joke	economy_climate
t3_jzxk30	Study: Noncitizen votes gave Biden wins in Arizona, Georgia -- 'Decimates' claim there's 'no evidence of large-scale fraud'	lawsuit
t3_jzxheo	WATCH: Poll monitor describes 4 a.m. Biden ballot dump -- 'I don't have faith in any election system after having witnessed this fraud'	lawsuit
t3_jzx2jg	"James Mattis: Joe Biden Must 'Eliminate ""America First""' from U.S. Foreign Policy"	policy
t3_jzw2s8	Trump Tells GSA, and His Team, to Begin the Transition Process; Vows to ‘Keep Up the Good Fight’	transition
t3_jzvyov	Perdue, Loeffler Join Trump Call for New Georgia Recount	lawsuit
t3_jzvpb2	Comment I found in a recent thread that I think that a lot of the doomer-skeptics need to read. Not necessarily saying that Trump will *totally* pull through with the evidence, but I think all you Reddit detectives should at least give him some reasonable benefit of the doubt.	vote
t3_jzvs4f	Trump Tells GSA, and His Team, to Begin the Transition Process; Vows to ‘Keep Up the Good Fight’	transition
t3_jzverf	Trump’s Case is a Constitutional One, Sidney Powell's is a Criminal One	lawsuit
t3_jzvcjq	Biden's national security adviser pick played key role in Clinton email scandal	lawsuit
t3_jzv491	Reince Priebus reacts to Wis. Dems' rule-change try following Trump recount filing: ‘You can’t make this up!'	lawsuit
t3_jzv44u	Trump Supporter Charged with Simple Assault for Breathing on Protesters	dissatisfaction
t3_jzuvjc	Trump Administration Begins Transition Process	transition
t3_jzua12	GSA notifies Joe Biden that Trump administration is ready to start transition process	transition
t3_jzu5h2	The Socio-Political Legacy 0f Trump	transition
t3_jzu0rh	Rush Limbaugh On Trump’s Legal Team: ‘They Promised Blockbuster Stuff And Then Nothing Happened’	dissatisfaction
t3_jzu0lg	Walter Mead: Biden’s Foreign-Policy Team Takes Shape	transition
t3_jztzoa	The mullah report: is Biden bringing back the Iran Deal? | Spectator USA	policy
t3_jztwv2	Revolving Door: Obama Staffers Who Joined NBC, MSNBC, and CNN, Now Headed to Biden Admin	transition
t3_jztmee	Trump Responsible For Largest Rescue of American Hostages	dissatisfaction
t3_jzth0n	Seven Letter Poll: 79 Percent of Trump Voters Say Election 'Stolen'	dissatisfaction
t3_jztdbg	"Washington Post publishes and retracts headline: ""Washington’s aristocracy hopes a Biden presidency will make schmoozing great again."""	transition
t3_jztcs5	Dems Threatened Govt Official, Her Family And Pets in Order to Obtain Govt Transition Funds for Biden	dissatisfaction
t3_jzta4e	Trump Administration To Start Transition Process For Biden	transition
t3_jzt98m	Appeals Court Grants Expedited Review of Trump Campaign's Pennsylvania Lawsuit	lawsuit
t3_jzt6dy	Appeals court to review Trump's Pennsylvania case -- Legal team on track with plan to reach Supreme Court	lawsuit
t3_jzsxow	Trump Lawyer: Michigan Legislature Agrees to Hold Election Review Hearings	lawsuit
t3_jzsv52	Hunter Biden Arrives At White House Dressed As Turkey In Hopes Of Being Pardoned By Trump	dissatisfaction
t3_jzsh0c	Trump Lawyer: Michigan Legislature Agrees to Hold Election Review Hearings	lawsuit
t3_jzrtvc	N.Y. Times op-ed admits: Trump was correct, reopen the schools	covid
t3_jzrsl7	"DuPont’s Shaped Biden’s ""Views"" (no experience!) on Business"	economy_climate
t3_jzrhs0	Biden's Treasury Secretary: Janet Yellen	transition
t3_jzrh4s	Hours After Biden Picks Blinken For Secretary Of State – His Closet Door Swings Open On Iraq And Consulting	policy
t3_jzrfhk	Biden &amp; Corporate Charters: A Radical, Regressive Proposal	dissatisfaction
t3_jzrc5e	Rep. Nunes Worried Biden Will Shut Down Durham Investigation	lawsuit
t3_jzqyu6	Joel Kotkin: The Green End Game Runs Through Biden	economy_climate
t3_jzqrab	Poll: Americans Want Biden to Stay Out of Trump Investigations &amp; Pass on Progressive Policies for Now	policy
t3_jzqpbm	Rush Limbaugh criticizes Trump legal team for promising 'bombshells' and failing to deliver	lawsuit
t3_jzqca2	Trump scores two wins as Michigan legislature, federal appeals court agree to election reviews	lawsuit
t3_jzq2wb	Sidney Powell responds to Trump Campaign legal statement with agreement but an “epic” lawsuit is still coming this week	lawsuit
t3_jzq15s	Rush Limbaugh: Trump Needs to Hold Rallies in Georgia	vote
t3_jzpzzc	Janet Yellen Is Biden’s Pick for Treasury Secretary	transition
t3_jzpdpe	Trump's election lawsuit leads to 3rd Circuit grant for expedited review	lawsuit
t3_jzpd7w	JUST IN: Third Circuit Court of Appeals Grants Expedited Review For Team Trump’s Appeal in Pennsylvania	lawsuit
