Name	title	coding
t3_jzsg5c	Biden to pick Janet Yellen for Treasury secretary	
t3_jzsfv2	Obama calls Trump era an 'anomaly' in Canada-U.S. relations	
t3_jzsfqc	First Latino tapped to head DHS signals shift from Trump's hard-line immigration policies	
t3_jzsfbe	Trump attorney in Wisconsin argues absentee votes should be thrown out - including his own	
t3_jzser3	AP: Trump won 3.1M votes in Ohio, a new state record	
t3_jzseje	National Security Experts Urge Republicans To Demand Trump Concede The Election	
t3_jzscgu	GM Abandons Trump Admin in Lawsuit Over California Emission Standards, a Sign Automaker Knows Biden Will Be Taking Over	
t3_jzsbmo	Michigan certifies Biden win; a setback for Trump challenge	
t3_jzsb0q	Michigan's state board certifies Biden's win	
t3_jzs7ix	G.M. Drops Its Support for Trump Climate Rollbacks and Aligns With Biden	
t3_jzs7bo	Michael J Fox compares Trump to Back to the Future villain: ‘Biff is president’.	
t3_jzs6yd	PolitiFact - Trump's Pants on Fire claim about votes exceeding voters in swing states	
t3_jzs5wi	Michigan board votes to certify the state’s election results, dealing Trump another blow	
t3_jzs4qi	Detroit had more vote errors in 2016 when Trump won Michigan by a narrow margin. He didn’t object then.	
t3_jzs2sh	Carl Bernstein says 21 Republican members of U.S. Senate have expressed disdain for Trump	
t3_jzs1zq	How Trump's fundraising could benefit his post-White House political life	
t3_jzs0fi	Michigan Certifies Joe Biden's Election Victory	
t3_jzs06l	Michigan certifies Joe Biden's win despite Trump's GOP overtures | The Board of State Canvassers, which has two Republicans and two Democrats, confirmed the results on a 3-0 vote with one abstention	
t3_jzrzv8	Rush Limbaugh Knocks Trump's Lawyers For Not Providing Voter Fraud Proof	
t3_jzrztf	CEOs Urge Trump To Concede: 'Not A Moment To Waste' In Fighting COVID-19	
t3_jzrye4	Michigan votes to certify Biden's win over Trump	
t3_jzrxcw	Biden's pick for top spy brings experience from CIA and White House	
t3_jzrxcf	Trump set to veto defense bill over renaming bases honoring Confederate leaders	
t3_jzrwp5	GSA offers to brief lawmakers on Biden transition next week; Emily Murphy won't host	
t3_jzrwkf	Trump’s vote fraud claims draw continued scrutiny from Twitter	
t3_jzrwf7	Indiana senators Braun and Young deny report they privately hold Trump in contempt	
t3_jzrwc2	Pennsylvania Supreme Court Kills Trump Bid to Disqualify Ballots	
t3_jzrvao	Michigan votes to certify Biden's win over Trump	
t3_jzrv9z	Mnuchin to End Key Fed Emergency Programs, Limiting Biden	
t3_jzrv7q	Trump's top election lawyer in Wisconsin says he and his wife voted illegally in the campaign's latest legal argument	
t3_jzrv19	Georgia sets timeline for Trump-requested recount	
t3_jzruwz	General Motors’ parting shot at Trump bodes well for the Biden presidency	
t3_jzruw3	Trump loses yet again as Michigan's state board certifies Biden's win	
t3_jzrtx4	Biden to nominate Janet Yellen as first female Treasury secretary: report	
t3_jzrtop	Bipartisan Michigan election board certifies Biden’s win on 154,000-vote margin	
t3_jzrtio	Biden Picks Foreign Service Veteran Linda Thomas-Greenfield For U.N. Ambassador	
t3_jzrspx	'Special jeopardy': 100 former Republican national security officials warn Trump must allow transition	
t3_jzrr0v	Analysis: Biden's pick for U.N. envoy will find waning American influence	
t3_jzrqsw	Joe Biden Picks Pro-Migration Swamper for Top DHS Slot	
t3_jzrq5g	Michigan election board votes to certify Biden win, dealing blow to Trump effort	
t3_jzrpuy	Michigan's state board certifies Biden's win	
t3_jzrpbc	Trump campaign to ask appeals court to halt Biden win in Pennsylvania	
t3_jzrp6i	Can Democrats Win Georgia Without Trump on the Ticket?	
t3_jzrnx5	Michigan certifies Biden victory in another blow to Trump	
t3_jzrmfo	Who is Sidney Powell, the lawyer the Trump campaign is now distancing itself from?	
t3_jzrmdg	Michigan certifies Biden win despite Trump's GOP overtures	
t3_jzrmc0	Trump’s Ridiculous, Sloppy Coup Attempt Just Face-Planted in Michigan	
t3_jzrlnt	Michigan certifies Biden win despite Trump's GOP overtures	
t3_jzrlc7	Maine certifies Biden’s victory in the state’s election	
t3_jzrl9q	Michigan's state board certifies Biden's win	
t3_jzrl06	Chris Christie calls Trump's legal team a 'national embarrassment'	
t3_jzrkeu	Michigan Certifies Election Results Showing Biden Victory	
t3_jzrk2b	Michigan board certifies Biden's victory in the state	
t3_jzrjiy	Michigan board of state canvassers certifies results of November 3 U.S. presidential election for Democrat Biden	
t3_jzrjet	Michigan election board certifies 154,000-vote victory for Joe Biden, another setback in Trump’s effort to overturn election results	
t3_jzrj8r	Michigan's state board certifies Biden's win	
t3_jzri76	Michigan board of state canvassers certifies results of November 3 U.S. presidential election for Democrat Biden	
t3_jzrgvq	Biden Team Highlights Cybersecurity Focus With First Cabinet Picks	
t3_jzrguj	Michigan certifies Biden win despite Trump's GOP overtures	
t3_jzrfd8	Michigan's state board certifies Biden's win	
t3_jzrfd5	Michigan board votes to certify the state’s election results, dealing Trump another blow	
t3_jzreko	Michigan's state board certifies Biden's win	
t3_jzrdys	Schisms emerging between Far-Right Fox News and soon-to-be former President Donald Trump	
t3_jzrd9l	Progressives urge Biden away from including Obama energy secretary in administration	
t3_jzrd1u	Biden chooses former Fed Chair Janet Yellen to be Treasury secretary	
t3_jzrcyi	President-elect Joe Biden's administration will include the first female to serve as VP, Treasury Secretary, Defense Secretary and Director of National Intelligence in U.S. history	
t3_jzrcrn	Michigan certifies Joe's Biden win despite Trump's GOP overtures	
t3_jzrcjf	Michigan election board votes to certify Biden win, dealing blow to Trump effort	
t3_jzrchd	Michigan board votes to certify the state’s election results, dealing Trump another blow	
t3_jzrbwa	Michigan election board votes to certify Biden win, dealing blow to Trump effort	
t3_jzrbs8	Former Fed Chair Janet Yellen reportedly Biden pick for Treasury Secretary	
t3_jzrbow	Election 2020 live updates: Michigan certifies election results finding Biden the winner	
t3_jzrbkx	How Trump's fundraising could benefit his post-White House political life	
t3_jzrbbr	Michigan certifies Biden win despite Trump's GOP overtures	
t3_jzrauu	Election 2020 live updates: Michigan certifies election results finding Biden the winner	
t3_jzratd	Michigan board votes to certify the state’s election results, dealing Trump another blow	
t3_jzrar7	Michigan board votes to certify the state’s election results, dealing Trump another blow	
t3_jzra8r	In blow to Trump, Michigan canvassing board certifies election results	
t3_jzr9x7	Michigan election board certifies 154,000-vote victory for Joe Biden, another setback in Trump’s effort to overturn election results	
t3_jzr8px	Michigan certifies Biden win despite Trump's GOP overtures	
t3_jzr8dl	Michigan certifies Biden win despite Trump's GOP overtures	
t3_jzr8aw	Michigan election board certifies Biden win	
t3_jzr88b	Michigan election board certifies 154,000-vote victory for Joe Biden, another setback in Trump’s effort to overturn election results	
t3_jzr85t	Michigan election board votes to certify Biden win, dealing blow to Trump effort	
t3_jzr803	Biden plans to nominate Janet Yellen for Treasury secretary	
t3_jzr7w5	Trump campaign suffers new court loss in attempt to block Biden's win in Pennsylvania	
t3_jzr7kz	Michigan Certifies Joe Biden's Election Victory	
t3_jzr77v	Michigan board votes to certify the state’s election results, dealing Trump another blow	
t3_jzr751	Michigan board votes to certify the state’s election results, dealing Trump another blow	
t3_jzr71y	Trump campaign to ask appeals court to halt Biden win in Pennsylvania	
t3_jzr71p	Trump's top election lawyer in Wisconsin says he and his wife voted illegally in the campaign's latest legal argument	
t3_jzr6vb	Michigan's Board Of Canvassers Certified Biden's Win In A Big Loss For Trump's Desperate Bid To Overturn The Election	
t3_jzr6u0	Michigan Certifies Joe Biden's Election Victory	
t3_jzr64x	Alejandro Mayorkas, Biden's Pick For DHS Head, Would Be 1st Latino In Post	
t3_jzr5yp	Michigan Certifies Joe Biden's Election Victory	
t3_jzr5u4	Biden picks John Kerry as climate czar, Janet Yellen as Treasury secretary	
t3_jzr5f1	Michigan Election Board Certifies Victory for Biden	
t3_jzr4ue	Michigan Election Board Certifies Victory for Biden	
t3_jzr4r9	Georgia sets timeline for Trump-requested recount	
t3_jzr4dw	Michigan elections board certifies results from presidential election, sealing Biden’s win in state	
t3_jzr46b	Biden Picks Janet Yellen To Be Treasury Secretary	
t3_jzr438	From 'Alarming Red Flag' to 'Something We Can Work With,' Campaigners Respond to Kerry as Biden Climate Envoy	
t3_jzqzld	Trump campaign forces Georgia taxpayers to pay for second recount after first one confirms its loss. A hand recount of nearly 5 million votes confirmed Biden's win, but Team Trump wants to milk taxpayers even more	
t3_jzqz78	Trump will go, but Trumpism will remain	
t3_jzqwc4	Biden to choose ex-Fed chair Yellen as first woman Treasury secretary, allies say	
t3_jzqvlj	Biden Choosing Janet Yellen for Treasury secretary	
t3_jzquzq	GOP senator: No indication of widespread voting irregularities, window for Trump challenges is 'closing'	
t3_jzquid	Former Fed Chair Janet Yellen reportedly Biden pick for Treasury Secretary	
t3_jzqsc8	Americans Want Biden to Prioritize Unity Over Progressive Agenda, Survey Finds	
t3_jzqrf3	Bernstein names 21 Republican senators who privately expressed contempt for Trump	
t3_jzqp20	Trump-Appointed Judges Find Conversion Therapy Bans Unconstitutional	
t3_jzqn1f	Trump fears Giuliani, other lawyers in Biden vote challenge are 'fools that are making him look bad'	
t3_jzqk4b	Secret Service members asked about protecting soon-to-be-former president Trump full time in Florida: Sources | Agents in Trump's detail have been asked about relocating to West Palm Beach.	
t3_jzqj8z	Trump Fears Giuliani, Other Lawyers in Biden Vote Challenge Are ‘Fools That Are Making Him Look Bad’	
t3_jzqiqp	Biden Choses Alejandro Mayorkas As His Secretary Of Homeland Security	
t3_jzqioi	Poll: Majority say Trump should concede	
t3_jzqh7h	Trump campaign suffers new court loss in attempt to block Biden's win in Pennsylvania	
t3_jzqg3e	Trump campaign suffers new court loss in attempt to block Biden’s win in Pennsylvania	
t3_jzqf5t	Republican Congressman Says GOP 'Embarrassing,' Calls on Party to 'Denounce' Trump's 'Conspiracy Theories'	
t3_jzqc18	Biden chooses former Fed Chair Janet Yellen to be Treasury secretary	
t3_jzqbl0	Republican Congressman Says GOP 'Embarrassing,' Calls on Party to 'Denounce' Trump's 'Conspiracy Theories'	
t3_jzq9v3	Bernstein names 21 Republican senators who privately expressed contempt for Trump | Donald Trump | The Guardian	
t3_jzq9tv	John Kerry named as Joe Biden's special climate envoy | US news	
t3_jzq7ps	Joe Biden expected to announce Janet Yellen as next treasury secretary pick	
t3_jzq7pa	Biden’s pick for Treasury Secretary will be Janet Yellen	
t3_jzq7ab	Trump Supporters in Georgia Threaten to Destroy GOP, Boycott Runoff Elections	
t3_jzq725	Biden chooses former Fed Chair Janet Yellen to be Treasury secretary	
t3_jzq5ss	Biden’s pick for Treasury Secretary will be Janet Yellen	
t3_jzq543	Committee Chairs Insist on GSA Briefing Tomorrow on Ongoing Refusal to Grant Biden-Harris Team Access to Transition Resources	
t3_jzq2dw	Poll: Majority say Trump should concede	
t3_jzq0ke	Biden To Nominate Former Fed Chair Janet Yellen For Treasury Secretary	
t3_jzq0dh	Biden’s Europe challenge: Repair tattered transatlantic ties | Four years of Donald Trump have done serious damage to mutual trust.	
t3_jzpyzb	Behind the scenes, Trump frustrated with his legal team's maneuvers	
t3_jzpy16	On Trump, GOP's silence 'can't be excused and won't be forgiven' — For the first time, a corrupt US leader is trying to cling to power through autocratic means. Let history note who lacked the patriotism to speak up.	
t3_jzpxxu	Biden taps Blinken to reshape U.S. foreign policy in post-Trump era	
t3_jzpwxq	Trump Is Blowing Up the Georgia GOP—and It Couldn’t Happen at a Better Time: His complaints about a “stolen” election have state Republicans in a circular firing squad, threatening their chances to win two Senate seats in January.	
t3_jzpvd8	Trump's bizarro-world 'elite strike force' legal challenge is about to implode	
t3_jzpvbh	Rush Limbaugh criticizes Trump legal team for promising 'bombshells' and failing to deliver	
t3_jzpuu9	Election officials are facing death threats in key swing states where Trump is trying to overturn the results of the 2020 presidential race	
t3_jzpt5h	Biden Expected to Pick Janet Yellen, Former Fed Chair, as Treasury Secretary	
t3_jzprxe	Trump’s Absurd ‘You Did It First’ Argument for Stealing the Election	
t3_jzpr6u	Trump Wants 3rd Circuit to Halt Pennsylvania Certification	
t3_jzpowr	Let’s hear it for the judges for dismissing Trump’s lawsuits	
t3_jzpo97	Biden taps first Latino to head DHS, first woman to lead intelligence	
t3_jzpmd7	Biden Expected to Pick Janet Yellen, Former Fed Chair, as Treasury Secretary	
t3_jzpllg	The Already Useless Trump Kids Are About to Get Even More So	
t3_jzpko2	Biden to pick ex-Fed chair Yellen for Treasury secretary: WSJ	
t3_jzpk7a	A major Trump donor’s company got a 3 percent government-backed pandemic loan. It sells title loans at a 350 percent annual rate.	
t3_jzpjm8	What if Trump won’t leave the White House? A hostage negotiator, an animal-control officer, and a toddler whisperer have advice	
t3_jzpilm	164 business leaders urge Trump to begin presidential transition for the sake of the country	
t3_jzphue	GOP senator, business leaders urge prompt Biden transition	
t3_jzpfqd	Pro-Trump Attorney Urges Republicans Not to Vote in Georgia Runoff	
t3_jzpff1	Corporate America is ready for a Biden presidency	
t3_jzpfan	Biden chooses former Fed Chair Janet Yellen to be Treasury secretary	
t3_jzpf1h	GM flips to California's side in pollution fight with Trump	
t3_jzpexr	What if Trump won’t leave the White House? A hostage negotiator, an animal-control officer, and a toddler whisperer have advice | Give him a five-minute warning, use food as a lure, remind him he has something to live for.	
t3_jzpeei	Trump Is Blowing Up the Georgia GOP—and It Couldn’t Happen at a Better Time	
t3_jzpddc	Land conservation plan stirs fight over Trump restrictions	
t3_jzpd2k	Factbox: The Biden Cabinet - President-elect builds his foreign policy team	
t3_jzpbvs	Biden chooses former Fed Chair Janet Yellen to be Treasury secretary, report says	
t3_jzpbaz	General Motors Reverses Course, Spurns Trump-Backed California Emissions Lawsuit	
t3_jzp967	General Motors Aligns With Biden, Pulls Out of Lawsuit Supporting Trump	
t3_jzp95d	Despite Trump’s prod, Mich. to consider certifying Biden win	
t3_jzp8jd	Alejandro Mayorkas, Biden's Pick For DHS Head, Would Be First Latino In Post	
t3_jzp787	Unpacking Joe Biden's decision to tap John Kerry as his climate envoy	
t3_jzp6x0	"Marjorie Taylor Greene ""solidly convinced"" Trump won Georgia despite state certifying Biden's win"	
t3_jzp5u8	Biden Brain Trust: Forget the Billionaires, Guillotine the Corporations	
t3_jzp4fh	Is Trump Selling Tickets to His 2021 Inauguration?	
t3_jzp2ts	Joe Biden nominates first woman to lead intelligence and first Latino to head homeland security	
t3_jzozd1	Why the Trump campaign’s big legal flameout in Pennsylvania seems like a turning point, even for Republicans	
t3_jzoyr6	Trump fears Giuliani, other lawyers in Biden vote challenge are 'fools that are making him look bad'	
t3_jzoykr	Trump's on his way out, but leaves a lasting legacy: The right's open embrace of terrorism	
t3_jzoxch	What Donald Trump and Dick Cheney Got Wrong About America	
t3_jzos3p	It’s Time To Consider Sanctions for Trump’s Legal Team	
t3_jzorp7	Rush Limbaugh: Trump Needs to Hold Rallies in Georgia	
t3_jzorhc	Trump fears Giuliani, other lawyers in Biden vote challenge are ‘fools that are making him look bad’	
t3_jzopwy	Why is Joe Biden considering this man to help fight the climate crisis?	
t3_jzopkn	Biden taps Alejandro Mayorkas as first immigrant to lead Homeland Security	
t3_jzopfi	EU's Michel invites Biden to 'rebuild' trans-Atlantic alliance	
t3_jzop8u	Why The Oil Industry Doesn't Fear Biden	
t3_jzoon5	Team Trump Fired QAnon Lawyer Sidney Powell But She's Tweeting Through It	
t3_jzonsl	Former Defense Secretary Jim Mattis says Biden should toss all of Trump's 'America First' policies	
t3_jzon8h	Plagued by COVID outbreaks, the meatpacking industry could be forced to change under Biden	
t3_jzomjx	Drip by drip, U.S. Republicans slowly break from Trump election claims	
t3_jzok9t	Bernstein names 21 Republican senators who privately expressed contempt for Trump	
t3_jzogjj	John Kerry to join Biden administration as National Security Council official dedicated to climate change	
t3_jzofom	Biden moves forward as GOP breaks with Trump rise	
t3_jzoe8p	A big inauguration crowd? Biden’s chief of staff expects ‘scaled-down’ event	
t3_jzodbz	Top Biden aide Ricchetti will be a White House liaison for Congress and business community	
t3_jzobu4	Behind the scenes, Trump frustrated with his legal team's maneuvers	
t3_jzoao6	Biden to name first female head of National Intelligence	
t3_jzoam2	Reality Forecloses on the Trump Presidency | A fading campaign collapses under the weight of finally having to back up big talk with actual substance.	
t3_jzo8pn	GM flips to California's side in pollution fight with Trump	
t3_jzo75x	GM hits reverse on Trump effort to bar California emissions rules	
t3_jzo73a	G.M. Drops Its Support for Trump Climate Rollbacks and Aligns With Biden	
t3_jzo5py	G.M. Drops Its Support for Trump Climate Rollbacks and Aligns With Biden	
t3_jzo58j	Biden picks Cuban-American lawyer Mayorkas as U.S. homeland security chief	
t3_jzo4ys	To Prevent 'Active Sabotage' of His Agenda, Biden Urged to Clean House of Trump Loyalists on Day One	
t3_jzo44d	Two years ago this week Trump was mocking a turkey for refusing to concede an election	
t3_jzo3qg	Clip of Ted Cruz Saying Democrats Would Say COVID 'Magically Better' Week After Biden Wins Resurfaces	
t3_jzo3o9	How Trump's destructive behavior emboldens authoritarian leaders abroad	
t3_jzo04h	Trump campaign takes Pennsylvania election fight to federal appeals court	
t3_jznz36	Did Trump Pardon a Turkey That 'Refused To Concede' an Election?	
t3_jznyip	Message to Joe Biden: No Torturers in the Next Cabinet. Biden and Harris must eschew anyone complicit in torture or who frustrated oversight.	
t3_jzny0i	Pennsylvania Republicans Voted Against Certifying Vote in County Trump Won by 22,000	
t3_jznx2m	Biden signals shift from Trump with national security picks	
t3_jzntq8	GM flips to California’s side in emissions lawsuit against Trump admin	
t3_jznr6e	Trump 2024? Two-thirds of GOP voters want him to run for president again, poll says	
t3_jznqim	Explainer: Despite Trump claims, voter fraud is extremely rare. Here is how U.S. states keep it that way	
t3_jznq3n	Clip of Ted Cruz Saying Democrats Would Say COVID 'Magically Better' Week After Biden Wins Resurfaces	
t3_jznpy5	Trump set on veto of defense bill over renaming bases honoring Confederates	
t3_jznkwh	John Kerry, Alejandro Mayorkas, Avril Haines among Joe Biden’s cabinet picks	
t3_jznjcm	Post-Trump, his party and his favorite network have to figure out their relationship with reality	
t3_jzniv7	Biden to name Kerry as U.S. climate czar, emphasizing diplomacy's role in the fight	
t3_jznd9v	Biden Picks Cuban-American Lawyer Mayorkas as U.S. Homeland Security Chief	
t3_jznb23	How Trump placed a ticking time bomb at the center of our system	
t3_jzna59	New Trump rule may require some African tourists to pay up to $15,000 in bonds	
t3_jzn4mo	Despite Trump’s prod, Mich. to consider certifying Biden win	
t3_jzn3cr	Biden Taps John Kerry For New National Security Role Focused On The Climate Crisis	
t3_jzn0c8	Biden taps John Kerry as Special Presidential Envoy for Climate, marking the first time the NSC will have an official dedicated to climate change	
t3_jzmvt2	Biden's inner circle get key cabinet posts as John Kerry named climate tsar	
t3_jzmvi7	Trump's on his way out, but leaves a lasting legacy: The right's open embrace of terrorism. How did the Kenosha shooter post $2 million in bail? Because conservatives are normalizing right-wing terrorism	
t3_jzmus9	Donald Trump’s Bid to Steal the Election Hinges on a Shameless Homophobe Who Once Called Him a Lying, Idiotic Bully	
t3_jzmubj	Joe Biden Names Picks for Secretary of State, Homeland Security Chief, Director of National Intelligence	
t3_jzmtno	Tucker Carlson was attacked by Trump supporters for questioning the outlandish claims of the president's lawyer Sidney Powell before she was fired	
t3_jzmsfq	Biden to name John Kerry as presidential climate envoy	
t3_k0g41t	YouTube suspends One America News, a Trump favorite, for peddling pandemic misinformation	
t3_k0g3pq	GOP Congressman Suggests Trump Voters Mimic Post-WWII Japanese Soldiers Who ‘Kept Fighting for Decades’	
t3_k0fyre	Biden certified as winner of Pennsylvania presidential vote	
t3_k0fwja	Is Parler censoring a pro-Trump hashtag started by Roger Stone?	
t3_k0fw1b	Biden to tap former Fed chief Yellen as first woman to head Treasury	
t3_k0fvdn	Rubio signals opposition to Biden Cabinet picks	
t3_k0ftlb	McConnell pushed Trump to nominate Coney Barrett on the night of Ginsburg's death: report	
t3_k0ftad	Joe Biden's Cabinet Picks Send a Clear Message: The Adults Are Back in Charge	
t3_k0fphc	Trump will soon leave the White House. How long before he stops dominating the conversation?	
t3_k0fp5n	Why are Missouri and Kansas senators still afraid to say it? Joe Biden won the election.	
t3_k0fogs	Who are Joe Biden's top cabinet picks?	
t3_k0fixz	"Is Trump's No Concession Endgame a ""Stab-in-the-Back"" Gambit Which Helped Bring the Nazis to Power?"	
t3_k0fh0r	Joe Biden Is Filling His Cabinet With Pro-War Hawks	
t3_k0fgz7	Biden says he'd meet with Trump 'if he asked'	
t3_k0ffko	Rubio takes aim at Biden’s ‘Ivy League’ foreign policy Cabinet nominees	
t3_k0feo8	Georgia Republican Voters Consider Boycott Of Special Senate Election In Support Of Trump	
t3_k0fdxm	How Trump’s Strategy for Outpacing the Law Finally Fell Apart	
t3_k0fdt6	The Majority of Republicans Would Like to See Trump run Again in 2024.	
t3_k0fd6y	Demanding Reversal of Trump Cruelty, Immigrant Rights Groups Welcome Biden Pick of Mayorkas for DHS Secretary|The former director of U.S. Citizenship and Immigration Services was a key architect of the Deferred Action for Childhood Arrivals program	
t3_k0fd6n	White House approves intelligence brief for Biden	
t3_k0f9d4	'Well that was weird as s***': Reporters caught on hot mic baffled by Trump's minute long press conference | The president previously warned voters that the stock market would tank if Joe Biden won the election	
t3_k0f8sr	Biden's Drug Policies Are Still Oppressive	
t3_k0f7st	"Small but growing number of Republicans tell Trump it's over: ""Stop golfing and concede"""	
t3_k0f7jr	Biden unveils a national security team without grifters, trolls or fanatics	
t3_k0f7cb	Defenders of US Public Schools Call on Biden to Ditch Trump's Disastrous Education Policies—and Obama's Too	
t3_k0f57y	Shirkey: Lawmakers told Trump they have no role in election	
t3_k0f3pm	New Trump rule could require up to $15,000 bond for travel to US	
t3_k0f2ph	From the coronavirus to the environment, Biden plans to take government in new direction	
t3_k0f2dx	Biden's pick for US spy chief played a central role in Obama's secretive drone war that resulted in hundreds of civilian deaths	
t3_k0f0zp	Watch Trump's Stock Market Collapse Prediction Go Down in Flames	
t3_k0f0sb	Joe Biden’s early appointments are showing a deft touch	
t3_k0f0p1	White House signs off on Biden receiving intelligence briefs	
t3_k0f05j	How Trump's legal battles to overturn the election undermine the Black vote	
t3_k0ezft	Biden to begin receiving classified Presidential Daily Briefings	
t3_k0exmu	For Trump, it’s all over but the tweeting	
t3_k0eshp	Trump Appointee Unconstitutionally Interfered With VOA, Judge Rules	
t3_k0esea	The Trump administration is considering shortening the recommended quarantine time for Covid-19	
t3_k0eov2	Trump skips turkey jokes, gives thanks for COVID-19 vaccines	
t3_k0eoay	'America is back': Biden pushes past Trump era with nominees	
t3_k0ek8c	Biden's foreign policy team lays out a national security vision that differs sharply from Trump's	
t3_k0ehzb	What We’ve Learned About The Biden Administration From His Staffing Choices So Far	
t3_k0egox	"At Trump's final bizarre turkey pardon, his ongoing refusal to concede was the elephant in the room. The president talked up the Dow and made a racist swipe at the ""China virus,"" but no mention of the transition"	
t3_k0effc	'America is back' , says Biden as he unveils team	
t3_k0e84j	Progressives Cheer Joe Biden's First Round of Cabinet Picks: 'A Great First Step'	
t3_k0e454	Paul Ryan calls on Trump to concede and end lawsuits	
t3_k0e2uk	Donald Trump's Destruction Of Documents	
t3_k0e1h9	Biden-Harris ticket surpasses 80 million votes: new record	
t3_k0e1gu	Kemp decries ‘baseless attacks’ from Trump supporter	
t3_k0dzgo	‘America is back’: Biden introduces historic Cabinet nominees who will ‘stand up for our values’	
t3_k0dyrm	The Republican Party Is Dead. It’s the Trump Cult Now.	
t3_k0dwtt	75% of every donation to Trump's leadership PAC could actually be spent by the president himself on things like paying family members or financing a 2024 bid	
t3_k0du5r	Ivanka criticised for boasting about greenhouse gas emissions drop under Trump administration	
t3_k0dtv5	White House has signed off on Joe Biden getting the President's Daily Brief	
t3_k0dshi	Poll: Biden must prioritize covid response	
t3_k0dsct	Trump Advisers Pushed for Transition as GOP Calls Grew	
t3_k0dq4l	White House reporters befuddled by brief Trump statement on stock market: 'Weird as s--t'	
t3_k0dppr	Wisconsin Republicans Blame Mark Zuckerberg for Trump’s Loss in Lawsuit	
t3_k0dovn	Kissinger tells Biden to go easy on China	
t3_k0dncv	Marco Rubio Gets Ripped For Criticizing Biden’s ‘Ivy League’ Foreign Policy Team	
t3_k0dmkk	State board certifies Joe Biden as winner in Minnesota	
t3_k0dlh2	Trump's DOJ Backs Down on Deporting Women Alleging ICE Gynecological Abuse	
t3_k0djl7	Trump Insists He’s Still Going to Be President as White House Landlord Asks For Forwarding Address for Security Deposit	
t3_k0dbia	Trump probably can't pardon himself. He may still try	
t3_k0db7w	Biden picks Alejandro Mayorkas, a son of Jewish Cuban refugees, to lead the Department of Homeland Security	
t3_k0davb	Generation Forever War: Biden’s National Security Picks Herald Return to Hawkish Normalcy	
t3_k0d8w9	AOC and Ilhan Omar want to block Biden’s former chief of staff	
t3_k0d7kj	Trump administration wants to cut food stamps to thousands of seniors, lawmakers say	
t3_k0d5dm	How Biden can fight climate change without Congress	
t3_k0d4sz	Canvassing board certifies Joe Biden's win in New Mexico	
t3_k0d4ji	Pro-Trump Congressman Called Out for Claiming in Lawsuit That He Was Harmed by Winning Election	
t3_k0d1g3	'Well That Was Weird as Sh*t': As More States Certify His Defeat, Trump Holds 60-Second Briefing to Brag About Stock Market	
t3_k0cxzw	Rubio derides Biden's foreign policy team: 'Polite and orderly caretakers of America's decline'	
t3_k0cv6t	Biden: 'It’s a team that reflects the fact that America is back'	
t3_k0coc2	Trump is junking a treaty - and two planes - designed to stop nuclear war	
t3_k0cmio	Experience makes a comeback: An early look at Joe Biden’s Washington	
t3_k0cidk	Trump will pardon turkey after agreeing to presidential transition	
t3_k0cdoc	Trump ignores reporter’s question about trying to pardon himself after doing so for turkey	
t3_k0ccxp	When it comes to prosecuting Trump, let’s be selective	
t3_k0ccin	Trump Takes A Break From His Bunker To Celebrate ‘Sacred’ Stock Market Gains	
t3_k0cbt5	Biden Cabinet picks may face rough Republican reception in Senate	
t3_k0c5mr	Paul Ryan calls for Trump to accept results: 'The election is over'	
t3_k0c4gk	Gov. Doug Ducey: 'Joe Biden did win Arizona'	
t3_k0c4e4	Biden unveils foreign policy team, signals shift from 'America First' policy	
t3_k0c42y	Biden win over Trump in Nevada made official by court	
t3_k0c2xg	How Biden Can ‘Build Back Better’ With or Without the Senate	
t3_k0c2ij	Biden says U.S. 'ready to lead' again on global stage	
t3_k0c237	As he ignores election defeat, Trump to pardon turkey	
t3_k0c01b	How Trump’s conspiracy theories have inspired some supporters to boycott the Georgia runoffs	
t3_k0bzv9	Trump Stress-Tested the Election System, and the Cracks Showed	
t3_k0by9d	Defund-Police Organizers to Biden: “We’re Not Going Away”	
t3_k0bxn0	From revolution to restoration: Biden picks Blinken, Yellen, Kerry for plum posts	
t3_k0bsrn	"Ivanka Trump called out for boasting about drop in greenhouse emissions: ""This is largely because of the pandemic"""	
t3_k0bpfr	Two more parting shots from Trump aimed squarely at disabled workers	
t3_k0bfgp	Trump shares bizarre videos and tweets by actor Randy Quaid about voter fraud, Fox News	
t3_k0beyi	Donald Trump stands up for the Confederacy one last time	
t3_k0bb2x	Trump’s QAnon Lawyer Inspired Even More George Soros Disinformation	
t3_k0bavd	Biden’s National Security team reveals he has learned from the mistakes of past presidents	
t3_k0b68g	Trump Had Less of an Impact on the World Than You Might Think	
t3_k0b15p	Trump-Appointed Judge Ensures That Lin Wood’s Bizarre Subpoena of the Atlanta Hawks Won’t Go Anywhere	
t3_k0azls	Trump’s Enablers Are Sabotaging the Georgia Senate Runoff Election–and Helping Democrats. There’s a weird, right-wing push to boycott January’s pivotal U.S. Senate runoffs. Is Trump angry enough to join it?	
t3_k0az01	Biden accuses Trump of ‘outright cruelty’ at the border as he introduces Homeland Security pick	
t3_k0axma	Biden win over Trump in Nevada made official by court	
t3_k0axg0	Rush Limbaugh: Trump’s Legal Team ‘Promised Blockbuster Stuff and Then Nothing Happened’	
t3_k0aw0f	Biden Introduces Foreign Policy and National Security Nominees	
t3_k0as5g	Judge rebukes another frivolous Trump lawsuit, allowing Pennsylvania to certify results	
t3_k0aqmf	Meadows pushed Trump to allow transition to begin	
t3_k0aqla	Watch Live: Biden Announces Key Cabinet Picks	
t3_k0ape6	Newsmax CEO Thinks Trump Should Concede When States Certify Elections, Would Support Overturning Electoral College	
t3_k0aolc	'The team meets this moment:' Biden introduces top admin nominees	
t3_k0anru	Trump pops into White House briefing room for one-minute impromptu speech	
t3_k0ammd	Nevada Supreme Court Certifies Biden’s Victory Over Trump	
t3_k0allo	Pennsylvania certifies election results, sealing state victory for Biden	
t3_k0ala4	Trump Turns to Randy Quaid for Guidance in Overthrowing Democracy	
t3_k0ahv4	Judge Emmet Sullivan Will Oversee Voting Rights Act Case Accusing Trump of Anti-Black Campaign to Overturn Election	
t3_k0afvh	Ducey acknowledges Biden victory in Arizona for 1st time	
t3_k0ae8g	Trump Loyalist is the leader of the Pentagon Transition	
t3_k0abt3	President-elect Biden Announces Foreign Policy and National Security Posts	
t3_k0a77w	President Trump Delivers Remarks	
t3_k0a761	Trump brags about Dow 30,000 at surprise press conference, leaves after a minute	
t3_k0a3tb	Trump shares Randy Quaid video: 'Fox is dead to me'	
t3_k0a31m	Biden-Harris ticket the first in US history to surpass 80 million votes	
t3_k09pwl	Atlanta Hawks Arena, Which Played Huge Role in Biden Winning Georgia, to be Used Again for Senate Runoffs	
t3_k09pft	Pennsylvania Supreme Court rejects Trump campaign's effort to block counting certain absentee ballots	
t3_k09ns0	Pennsylvania, Nevada certify Biden as winner of presidential vote	
t3_k09n7r	Nevada Supreme Court certifies Joe Biden's win in Nevada, making his win in the battleground state official	
t3_k09m8g	Pennsylvania certifies election results for Biden	
t3_k09ifr	U.S. To Execute Only Woman On Federal Death Row 8 Days Before Biden Inauguration	
t3_k09adn	Pennsylvania finalizes U.S. election results for Biden: governor	
t3_k0942q	Melania Trump wanted to light the White House with rainbow colors for Pride month. She got told no.	
t3_k0927g	How Can We Get Rid of Our Trump-Era Brainworms?	
t3_k08z5i	President-Elect Joe Biden Clinches Presidency—Again—as Pennsylvania Certifies Election Results	
t3_k08xyk	Democrats didn't refuse to acknowledge Trump’s 2016 victory	
t3_k08vm4	Pennsylvania certifies Biden’s victory as battlegrounds make 2020 results official	
t3_k08slh	On Night of Ginsburg’s Death, McConnell Pushed Trump to Nominate Amy Coney Barrett	
t3_k08rp0	Who is Janet Yellen, Biden’s pioneering pick to lead the Treasury amid a deep crisis?	
t3_k08q8s	Joe Biden Certified As Winner Of Presidential Election In Pennsylvania	
t3_k08o3z	Trump likely to win GOP presidential nomination in 2024, poll shows	
t3_k08nzg	Student Loan Advocates Release Roadmap for the Biden Administration to Fix Broken Programs for Servicemembers, Teachers, Defrauded Students, &amp; Other Vulnerable Borrowers Denied Promised Relief	
t3_k08lkd	Because of Trump sanctions, Western Union remittances come to an end in Cuba	
t3_k08kqr	Pennsylvania just certified its presidential election results, officially declaring Joe Biden the winner	
t3_k08kqp	The Damage Is the Point | Trump may not be able to extend his reign, but he can aid and abet his party by further curtailing the right to vote.	
t3_k08icm	Could Social Alienation Among Some Trump Supporters Help Explain Why Polls Underestimated Trump Again?	
t3_k08hyw	Election 2020 live updates: Pennsylvania certifies election results finding Joe Biden the winner	
t3_k08hk3	America survived Trump's coup attempt. The media needs to be clear about why.	
t3_k08gnv	Biden Is Picking a Diverse Team That Happened to Work for Obama	
t3_k08fht	Rubio Receives Swift Dunking For Poor Attempt At Painting Biden As An Elitist	
t3_k08ewo	Brennan takes final shot at Trump: 'I leave his fate to our judicial system, his infamy to history, &amp; his legacy to a trash heap'	
t3_k08c5o	The Biden Administration Must Beat Viral Misinformation Influencers at Their Own Game. Science communication expert Jessica Malaty Rivera has a few pandemic messaging tips for the incoming president.	
t3_k08b0h	Pennsylvania certifies Biden as winner of presidential vote	
t3_k087df	Who Joe Biden is picking to fill his White House and Cabinet	
t3_k08659	Pennsylvania certifies Biden victory	
t3_k084ea	Pennsylvania certifies Biden as winner of presidential vote	
t3_k08407	Pennsylvania certifies Biden win over Trump in state	
t3_k083ym	Pennsylvania Certifies Biden as Winner, Driving Stake in Trump’s Legal Effort	
t3_k08368	It will be Republicans who decide the mark Joe Biden makes on history | With a slim majority in Congress, the president-elect will wield little power. The past teaches us what may happen	
t3_k082qk	Watch Live: Joe Biden introduces new members of national security, foreign policy teams	
t3_k0826z	Trump’s Pentagon Now Vetting Nonpolitical Experts	
t3_k081u3	Kash Patel, recently installed Trump loyalist, now leading Pentagon transition	
t3_k081o8	Pennsylvania certifies results of 2020 presidential election, giving Biden the win	
t3_k081lm	Pennsylvania certifies election results for Biden	
t3_k080lt	Pennsylvania certifies Biden as winner of presidential vote	
t3_k080h9	Rubio calls Biden's national security team 'polite &amp; orderly caretakers of America’s decline'	
t3_k08031	Trump: I’ll Keep Charging Fraud Until Randy Quaid Is Satisfied	
t3_k07zev	Computer repairman who claimed he gave Hunter Biden data to Giuliani closes shop as laptop saga gets stranger	
t3_k07ybo	Joe Biden set to introduce national security team today as Obama-alumni heavy administration takes shape	
t3_k07u3h	Trump has set a hidden trap for Biden. It could do great damage.	
t3_k07u24	Pennsylvania governor: Democrat Joe Biden certified as winner of presidential election in state	
t3_k07txz	Pennsylvania certifies Biden as winner of presidential vote	
t3_k07siq	Mark Hamill Reacts to Trump Considering Randy Quaid's Call for Election 'Do-Over'	
t3_k07sfh	It Actually Was a Landslide: 80 Million Votes and Counting For Biden; The “red mirage” has vanished to reveal a blue mandate for President-Elect Joe Biden	
t3_k07q55	Joe Biden crosses 80 million votes, 10 million more than Obama got	
t3_k07ocv	US election: Biden becomes first-ever presidential candidate to receive 80 million votes	
t3_k07nxi	Pennsylvania certifies Biden's victory	
t3_k07knr	Trump isn’t the obstacle to coronavirus aid. Pelosi is.	
t3_k07khz	Kremlin and Putin will not recognise president-elect Biden despite Trump announcement	
t3_k07jm6	Column: Trump lost and his lawsuits are garbage. But please keep donating! The grift must go on.	
t3_k07fhk	Janet Yellen Is Probably the Best Treasury Secretary We Could Expect from a Biden Presidency	
t3_k07cu4	Trump Campaign Continues To Fight As More Evidence Of Voter Fraud Emerges	
t3_k07cr0	Trump administration to reportedly dispose of Open Skies treaty planes	
t3_k07c8p	Trump bump: NYT and WaPo digital subscriptions tripled since 2016	
t3_k07b93	Donald Trump Is Now Retweeting Randy Quaid’s Election Rants And Do-Over Calls	
t3_k078it	Trump: 'Will Never Concede' Despite Transition Process OK	
t3_k06pds	Fox News' Laura Ingraham and Tucker Carlson distance themselves from Trump	
t3_k06l7z	Yes, the Biden administration should hold Trump accountable	
t3_k06kb5	The Finance 202: Yellen will face host of political problems as Biden's treasury secretary	
t3_k06g46	'Shameful and Concerning He Is Even Being Considered,' Says AOC as Rahm Emanuel Floated for Role in Biden Cabinet	
t3_k06fcj	Trump To Pardon Turkey Again, Trying To Show Normalcy Amid The Abnormal	
t3_k06dr2	No, It Wasn’t a Coup Attempt. It Was Another Trump Money Scam.	
t3_k06cum	Turkeys, Corn and Cob, expected to be first in slew of final Trump pardons	
t3_k06bmj	Trump Mocked After Telling GOP to Listen to Randy Quaid's Election Demand	
t3_k06b25	Virginia Democrats, Thrilled With Biden Victory, Aren’t Looking for Carbon Copy - Suburban women who played a huge role in Joe Biden’s victory are not convinced that they need a white man to win their governor’s race next year.	
t3_k063d1	The Real Reason Trump’s Lawsuits Disproportionately Target Black and Latino Voters	
t3_k061wu	Republicans With Any Love of Country Must Acknowledge That Trump Has Lost	
t3_k060rf	Laura Ingraham says that Biden will be president: ‘This constitutes living in reality’	
t3_k05ze0	Biden cabinet: Janet Yellen set to become first female treasury secretary	
t3_k05ynk	Fox's Laura Ingraham says Biden will be inaugurated: 'This constitutes living in reality'	
t3_k05u50	Glum Laura Ingraham Tells Fox Viewers It’s Done: ‘I’d Be Lying’ If I Said Trump Still Had A Chance	
t3_k05tem	Avril Haines: Joe Biden’s nominee for top intelligence post once held ‘erotica nights’ at bookstore	
t3_k05rsm	Tucker Carlson: Yes, the election was rigged for Joe Biden. Here's how	
t3_k05npo	Trump Is Still President, Even Though He’s Not Acting Like One | The federal government has essentially stopped functioning as a federal government.	
t3_k05kkv	Every Day Trump Repeatedly Emails His Supporters a Dangerous Message: Democracy Doesn’t Work. Be outraged, don’t accept the election results…and send money.	
t3_k05jjg	Here's How Scientists Want Biden to Take on Climate Change	
t3_k05ja4	Since Election Day, a Lot of Tweeting and Not Much Else for Trump	
t3_k05ixh	2 in 3 say coronavirus relief should be Biden's top priority in first 100 days: poll	
t3_k05hus	Donald Trump Backing Don Jr. or Ivanka for 2024 Is Fine by Republicans—but They Prefer Mike Pence	
t3_k05ep2	Surgeon General Issues ‘Dire’ COVID-19 Warning As Trump White House Plans Indoor Parties	
t3_k055sr	Republicans sold out democracy to appease Trump's loser tantrum	
t3_k04x2c	Cannabis stocks surge after Trump administration sets formal transition in motion	
t3_k04vzj	Trump’s dam finally breaks. But we cannot go through this again.	
t3_k04vjz	Why Newsmax Supports Trump’s False Voter-Fraud Claims	
t3_k04rde	Trump lost the 2020 election to Biden. But could he win in 2024?	
t3_k04qk9	Jon Ossoff Tries to Drive Wedge Between Georgia Trump Voters, GOP Senate Candidates Over Biden Win	
t3_k04nof	Biden prioritizes climate crisis by naming John Kerry special envoy	
t3_k14dck	Trump takes his fraud claims to a hotel ballroom — by phone	
t3_k14cot	Biden says he's considering putting Trump voter in administration for unity	
t3_k14bxz	Justice Department appeals ruling in E. Jean Carroll lawsuit, seeking to replace President Trump as defendant	
t3_k14as7	The Supreme Court fight over Trump’s last-ditch effort to rig the census, explained	
t3_k13uia	Ocasio-Cortez doubles down on Biden keeping Emanuel out for 'covering up a murder'	
t3_k13n1j	'Shameful': Progressives are angry Biden is considering a Cabinet post for Rahm Emanuel despite his handling of the police shooting of an unarmed Black teenager	
t3_k13eyv	Donald Trump Calls In to Gettysburg Hearing: We Have to Overturn Election Because Democrats Cheated	
t3_k13deu	Biden seeks unity as Trump stokes fading embers of campaign	
t3_k13c26	Trump’s hopes sputter to end in Michigan. ‘It’s over, and they know it.’	
t3_k13ard	Almost everything Trump said at a Republican event in Pennsylvania about the election was a lie or a conspiracy theory	
t3_k138sb	'A cabinet that looks like America': Harris hails Biden's diverse picks	
t3_k1353z	Biden says he'll push 'pathway to citizenship for over 11 million undocumented people' in first 100 days	
t3_k132at	Trump's concession speech, as if he'd actually give one	
t3_k12s6a	"House Democrats seek list of Trump appointees ""burrowing in"" to Biden administration"	
t3_k12qwf	Trump suddenly irrelevant, Biden steals Thanksgiving spotlight with call for unity	
t3_k12m2q	'Major Test' for Soul of Biden Presidency: AOC, Ilhan Omar Back Effort to Keep Deficit Hawk Bruce Reed Out of White House	
t3_k12jmq	Biden's pick for US spy chief played a central role in Obama's secretive drone war that resulted in hundreds of civilian deaths	
t3_k12h7v	Joe Biden Should Investigate Trump, Dem Rep Argues: 'We Cannot Dismiss Accountability'	
t3_k12fkx	Trump’s Lawyers Just Performed Another Embarrassing “Election Fraud” Show	
t3_k12dib	President-elect Joe Biden's Thanksgiving address as prepared for delivery	
t3_k12c8y	Judge Presiding Over ‘Bonkers’ Election Lawsuit Blocks Whatever Hasn’t Been Certified of Biden’s Certified Pa. Victory	
t3_k12br3	Biden leans toward Donilon as CIA chief	
t3_k12bmp	"Pennsylvania AG and Lt. Gov blast Trump, ""fake"" GOP election hearing: ""devoid of reality"""	
t3_k12a3k	Biden offers a message of unity on Thanksgiving Eve as Trump airs grievances and spreads conspiracy theories	
t3_k126t7	Dialing into Pa. GOP meeting, President Trump shows no sign of concession	
t3_k124r4	How Democrats should exploit Trump’s continued effort to hold the GOP hostage	
t3_k124oq	President Trump Phones into Pennsylvania Republican Hearing on 2020 Election	
t3_k122ne	Trump order could spark mass firings of civil servants before inauguration, lawmakers warn	
t3_k11y4x	Mueller prosecutor says next attorney general should investigate Trump	
t3_k11x1z	Trump Complains On Speakerphone To PA GOP That No One Will 'Overturn' Election For Him	
t3_k11uyd	Trump Has Lost the Will to Be Blond	
t3_k11tae	DOJ appeals ruling that said it can't take the place of Trump in E. Jean Carroll defamation suit	
t3_k11o5n	DOJ Is Still Trying to Defend Trump Against Rape Accuser E. Jean Carroll’s Lawsuit During Lame-Duck Session	
t3_k11mco	Trump asks Pennsylvania lawmakers to ‘turn around’ election results during GOP event in Gettysburg	
t3_k11ip5	Column: Brace yourself for Trump’s scorched-earth attacks on health and safety	
t3_k11ggr	Trump refuses to accept Biden's win as transition proceeds	
t3_k1169e	Joe Biden Says the U.S. Will Lead on Climate. But First He Has to Regain World Leaders' Trust	
t3_k115zd	Trump calls into Pennsylvania hearing, rambles about voter fraud on speakerphone	
t3_k115h8	Want to understand Biden voters? Here’s your reading list.	
t3_k10zvu	"Mnuchin clawback may “sabotage” Biden by blocking $455B in COVID-19 funds — it may also be “illegal”. A watchdog says Mnuchin’s move violated the Cares Act. Democrats call it downright ""corrupt"""	
t3_k10uhs	Trump rants about overturning the election even as administration begins transition to Biden	
t3_k10ua8	White House Weighs Pardon Blitz Before Trump’s Exit	
t3_k10u0q	Biden calls for nation to unite in COVID-19 fight in Thanksgiving address	
t3_k10put	Joe Biden calls for shared sacrifice to fight the pandemic as Trump rails about baseless election accusations	
t3_k10if8	Trump calls into Pennsylvania meeting to renew election claims	
t3_k10g9z	Bernie Sanders Criticizes Trump for Touting Dow Record as Millions of Americans Won't Have Enough Food on Thanksgiving	
t3_k10by4	Trump's Tweets Attacking the Election Echo Russian Trolls	
t3_k108o1	Trump Calls Into Rudy Giuliani’s Latest Election Fraud Pantomime: The much-hyped “hearing” on election issues will not change the outcome of the election.	
t3_k1085e	As Trump’s stage set is struck, his disastrous plot plays out	
t3_k106ny	Analysis from Washington Even in admitting defeat, Donald Trump claims victory	
t3_k105kc	Joe Biden Appeals for Unity in Thanksgiving-Eve Address	
t3_k1043w	Trump’s handling of coronavirus pandemic ‘shambolic’, says Obama	
t3_k102sr	Trump isn't the reason we can't quit Trump — the obsession is really about his followers	
t3_k102eh	'Losing': Why Trump Lost Every 2020 Election Plot - The Lessons For The U.S.	
t3_k101h5	Biden urges Americans to recommit to fighting pandemic in Thanksgiving address	
t3_k0zznp	Biden should grant GSA Cabinet-level status — and its independence	
t3_k0zzn9	No, President Trump Did Not Pardon Himself	
t3_k0zxjg	Congress braces for Biden’s national coronavirus strategy	
t3_k0zwpq	Trump demands election results ‘overturned’ and claims GOP poll watchers ‘treated like a dog’	
t3_k0zt1g	‘We’re at war with the virus, not with one another’: Biden delivers Thanksgiving address as nation reels from coronavirus	
t3_k0zqlf	Biden gives Thanksgiving address from Delaware	
t3_k0zp9f	President-elect Biden Delivers Thanksgiving Address	
t3_k0zoxm	'Truly Grotesque': On Way Out the Door, Trump Prioritizes Bringing Back Executions by Firing Squad and Electrocution	
t3_k0zlmy	The Women Activists Rejecting Biden’s Pro-War “Feminism”	
t3_k0zjrf	Trump Knows His Lawsuits Don’t Stand a Chance, But He’s Using Them to Raise Money for His Next Move	
t3_k0zjh9	US should encourage China's rise, Biden national security pick Jake Sullivan says	
t3_k0zi5p	Huge court win lets Trump present ballot evidence, could overturn Nevada result	
t3_k0zi53	Biden team hides secret job advert in source code of presidential transition website	
t3_k0zh1q	Trump pushing through dozens of last minute policy changes – including use of firing squads	
t3_k0zes8	Trump campaign sued for attempting to disenfranchise Black voters	
t3_k0zek5	Rouhani: Iran and US can return to time before Trump	
t3_k0zcsn	'Biff is president': Michael J. Fox says Trump has played on 'every worst instinct in mankind'	
t3_k0zcp6	In an apparent dig at the Trump administration, Obama says Biden's foreign policy team will 'know where countries are'	
t3_k0zb6z	Joe Biden becomes first presidential candidate in U.S. history to surpass 80 million votes	
t3_k0zaef	Trump’s Next Two Months of Mayhem	
t3_k0z706	Trump Lawyer Jenna Ellis Defends Truth Using Fake Teddy Roosevelt Quote | The campaign’s legal adviser posted a tweet using a quote falsely attributed to the 26th president defending truth.	
t3_k0z4yk	Biden's rumored choice for secretary of defense may make history, but she won't do Biden any favors	
t3_k0z2ui	Cancer Alley Community Leaders Are Cautious As Biden Picks Their Fossil Fuel-Friendly Congressman for White House Role	
t3_k0z0g5	Barbara Ransby &amp; David Sirota Warn of Close Links Between Biden’s Cabinet Picks &amp; Corporate Power	
t3_k0yz88	Trump team’s bizarre legal fight channels the McCarthy era	
t3_k0yyxm	Trump Admin Ignored Internal Concerns When Clipping Bird Protections, Documents Show	
t3_k0ysz6	Scarborough says he'll never return to Republican party after GOP supported Trump	
t3_k0yqon	The Trump administration is aiming to bring back firing squads and electrocutions for some federal executions	
t3_k0yo9m	Biden appears to pour cold water on Warren and Sanders joining Cabinet	
t3_k0yjn1	Trump cancels trip to Pennsylvania GOP meeting on election irregularities, source says	
t3_k0ygi5	Trump administration denies permit for divisive Alaska mine	
t3_k0yf3v	China's Xi Jinping Congratulates Biden On Election Win, Urges Cooperation	
t3_k0yep7	Trump 1st President Since Carter Not to Send Troops Into New Conflict	
t3_k0ycyt	Trump officials hold first 'Operation Warp Speed' briefing for Biden	
t3_k0yc64	"New Poll Shows 68% of Americans Want Senators to Block Any Corporate Biden Nominees | Progressives are calling on the president-elect to reject a ""Corporate Cabinet"" and instead pick ""people dedicated to working in service of the general welfare."""	
t3_k0y3k8	Obama Claims Evangelical Latinos Disregarded Trump’s Racism Because of Views on ‘Abortion,’ ‘Gay Marriage’	
t3_k0y00m	Biden’s national security rollout doesn’t include a Pentagon pick	
t3_k0xx00	Florida Rep. Matt Gaetz: Trump should pardon himself to stop ‘radical left’	
t3_k0xvbf	100+ Public Health and Justice Leaders Call on Biden to Reject 'Global Vaccine Apartheid,' Ensure Doses 'Free and Available to All'	
t3_k0xqeh	President Trump Should Pardon Himself to Stop ‘Radical Left,’ Florida Congressman Says	
t3_k0xlfj	"Trump cancels trip to GOP fraud “hearing” at Pennsylvania Wyndham after Giuliani exposed to COVID-19. The campaign said similar ""hearings"" were planned in Michigan and Arizona, but that was news to GOP officials there"	
t3_k0xkqa	Trump administration denies permit for Pebble mine in Southwest Alaska	
t3_k0xkq3	Trump’s Embarrassingly Bad Legal Case in Pennsylvania No wonder his campaign kept swapping out its lawyers.	
t3_k0xjcr	Sen. Cotton says Biden’s Cabinet picks signal return of Obama's ‘disastrous’ foreign policy	
t3_k0x6x6	Donald Trump is losing thousands of Twitter followers after election defeat	
t3_k0x266	Biden: I am not going to shut down the economy, period	
t3_k0x19o	Trump Legal Team Wants Rudy Giuliani to Argue in Federal Court Again, But There Are Some Problems	
t3_k0x08b	King to remain in Senate as Biden plans to nominate former CIA official for intelligence post	
t3_k0wvag	Mueller prosecutor Andrew Weissmann says Trump should be investigated and charged with potential federal crimes after leaving office	
t3_k0wtut	Trump’s transgender ban has harmed US military, experts find	
t3_k0wrop	Trump attorney Rudy Giuliani to speak on election fraud before Pennsylvania state Senate	
t3_k0wmlm	Trump bails on surveillance treaty used to monitor Russia, guts program of resources	
t3_k0wm0d	Biden says Americans can worship in person 'safely.' But what does that mean?	
t3_k0wlug	Trump lawyer details far-fetched strategy to reverse Pennsylvania win for Biden	
t3_k0wk7g	Judge Rules Against Trump Ploy to Force Elderly Into Nursing Homes. Decision Blocks Effort to Keep States from Deducting Insurance, Union Dues from Home Healthcare Workers	
t3_k0wfq8	Cuomo stands up for Trump on media, says news organizations don't show respect	
t3_k0wf6f	GA Secretary Of State: My Family Voted Trump And Was ‘Thrown Under The Bus’	
t3_k0wd4c	Trump cancels plans to attend Pennsylvania GOP event on election	
t3_k0wcwi	Obama says Americans voted for Trump because Republicans cast white men as ‘victims’	
t3_k0wast	Trump campaign strategic advisor and unofficial Jewish liaison tests positive for coronavirus	
t3_k0wa0m	Biden to Unveil Economic Team Next Week -Transition Official	
t3_k0w7hg	Biden says Trump 'will go down in history as being one of the most irresponsible presidents'	
t3_k0w5xq	Republicans Are Really Trying to Argue that Biden’s Cabinet Picks Are Corrupt	
t3_k0w5uj	Biden Announces First LGBTQ+ Appointee in His Administration	
t3_k0w5ah	GOP Senator Suggests He May Oppose Biden's Treasury Pick, Says He 'Voted Against' Yellen for Fed	
t3_k0w4pc	Rahm Emanuel doesn’t deserve a job in Biden’s administration	
t3_k0w4g6	Trump, aides have discussed plans to pardon Michael Flynn: reports	
t3_k0w484	Congress Pays $850,000 to Muslim Aides Targeted in Inquiry Stoked by Trump	
t3_k0w32y	China's Xi Jinping finally congratulates Biden on his 2020 election win, with only a few world leaders still holding out	
t3_k0w1tc	Trump’s racist attacks on democracy open Pandora’s box for future suppression	
t3_k0w1os	Trump campaign says Michigan election hearing slated for next week. That's not happening	
t3_k0w03e	Biden’s IRS could finally give Trump’s tax returns to Democrats	
t3_k0vwu1	China’s President Xi Jinping sends delayed congratulations to Biden	
t3_k0vvxv	Trump's outcasts in the civil and foreign service may get a second chance under Biden	
t3_k0vvgw	60% of US Voters Support Biden Canceling $50,000 of Student Loan Debt Per Person: Poll	
t3_k0vsz3	Losing Hasn’t Changed Trump’s Stance on White Supremacy	
t3_k0vri0	Trump's about to turn the GOP into one long, humiliating episode of 'The Apprentice'	
t3_k0vn6o	Biden team to begin getting COVID-19 briefings	
t3_k0vm1n	Joe Biden to deliver a Thanksgiving address seeking US unity	
t3_k0ve3q	Prosecuting Trump is the only way to heal the nation	
t3_k0vbim	Trump’s Team Is Sabotaging the Transition	
t3_k0v9ok	Fauci says he would 'absolutely' serve on a Biden coronavirus task force	
t3_k0v7qa	Another Trump campaign advisor tests positive for coronavirus as Giuliani heads to Gettysburg	
t3_k0v7l7	Biden to receive first daily presidential briefing on Monday	
t3_k0v755	With the Planet at Stake, Climate Coalition Pressures Biden to Reject 'Corporate Shill' Ernest Moniz as Energy Chief	
t3_k0v71f	Biden’s UN Pick Boosts Morale for Diplomats Trump Sidelined	
t3_k0v6fv	'Under the bus': GOP official learns the limits of Trump's loyalties	
t3_k0v4fd	'America Is Back': Biden Pushes Past Trump Era With Nominees	
t3_k0v3rn	Arizona GOP Chair Files Last-ditch Lawsuit to Void Joe Biden's Win in State	
t3_k0v3em	Biden to unveil economic team next week -transition official	
t3_k0uxvn	Georgia secretary of state says he's a Trump voter 'now being thrown under the bus by him'	
t3_k0uv7d	Trump’s Election Lies Failed, but the Damage Is Done | Trump’s supporters, already steeped in white grievance, are predictably receptive to the idea that “illegal voters” have succeeded in stealing their democracy.	
t3_k0urqy	Adam Schiff Says If Trump Pardons Flynn He'd Be 'Acting Like An Organized Crime Figure'	
t3_k0urce	Mexico's president again declines to congratulate Biden on election win	
t3_k0uq91	Ga. GOP Secretary of State Says Trump 'Threw' His Family 'Under the Bus'	
t3_k0uq8x	AOC and Ilhan Omar sign petition calling on Biden not to give Bruce Reed administration role	
t3_k0ul70	President-Elect Joe Biden Hits 80 Million Votes In Year Of Record Turnout	
t3_k0ukqy	Biden soars as leader of the free world	
t3_k0uko4	Barbara Ransby &amp; David Sirota Warn of Close Links Between Biden’s Cabinet Picks &amp; Corporate Power	
t3_k0ujll	Trump adviser who was with Giuliani at press conference tests positive for coronavirus	
t3_k0ui6w	Gaetz: 'Trump should pardon everyone' including himself to quench liberal 'bloodlust'	
t3_k0ui3z	Chinese leader Xi Jinping congratulates Biden on winning election	
t3_k0ugew	Tracking the Trump Administration’s “Midnight Regulations”	
t3_k0uf58	Canvassing board certifies Joe Biden's win in New Mexico	
t3_k0ucpe	In refusing to acknowledge Biden win, McConnell again puts politics ahead of country	
t3_k0uawe	Trump tweets string of falsehoods about Wisconsin absentee voters	
t3_k0u78m	'America is back': Biden pushes past Trump era with nominees	
t3_k0u62y	Gov. Cuomo takes President Trump’s side against ‘disrespectful’ reporters	
t3_k0u20u	Trump to reportedly join Rudy Giuliani at Pennsylvania election event after aides 'tried talking him out of' going	
t3_k0u1nd	Putting Trump past us is like exiting an abusive relationship: it takes time. Under Trump many had a ‘collective hypervigilance and anxiety of what he might do next’, experts say – so how do we unpack these past four years?	
t3_k0typ9	China's Xi congratulates Biden on election	
t3_k0tynj	Michigan lawmakers told Trump they have no role in election	
t3_k0twoj	Joe Biden’s early picks for top advisors signal a return to stability, experience and sobriety	
t3_k0tujg	A New Jersey congressman is seeking to disbar Trump's personal attorney Rudy Giuliani after he touted election-related conspiracy theories	
t3_k0tp5h	McConnell Called Trump on Air Force One After Ginsburg Died, ‘Told’ the President ‘You’ve Gotta Nominate Amy Coney Barrett’: Report	
t3_k0tmzh	El Paso moves to collect outstanding debt from 2019 Trump campaign rally	
t3_k0tmvw	Trump Is Racing to Bring Back Firing-Squad Executions Before He Leaves Office, Says Report	
t3_k0tmc3	AOC insists Joe Biden can forgive student loans by executive order despite constitutional questions	
t3_k0tigo	Obama criticizes Trump on pandemic response: 'It's not rocket science'	
t3_k0tgk3	Georgia secretary of state says Trump threw him under bus despite his support	
t3_k0tepq	Trump told confidants he intends to pardon Michael Flynn: report	
t3_k0te9q	Biden says his team is already talking with Trump administration officials	
t3_k0te8w	President-Elect Biden Hits 80 Million Votes In Year Of Record Turnout	
t3_k0t74f	Trump's bizarre Georgia play: He wants to show Republicans he's still the boss	
t3_k0t6qn	Xi Jinping sends congratulations to US president-elect Joe Biden	
t3_k0t55y	Trump set to attend Pennsylvania Republicans' 'hearing' on voter fraud: reports	
t3_k0t2i7	Will Trump ever concede to Biden? Approving the transition may be as close as he gets to that, aides say	
t3_k0t1hf	Gaetz Urges Trump To Go Wild With Pardons, Including A Self-Pardon, To Own The Libs	
t3_k0t0ml	Fact check: Trump lawyer Sidney Powell falsely stated he won election 'by a landslide'	
t3_k0swn8	Biden says he hasn't heard from Trump directly	
t3_k0ssez	China’s president Xi Jinping finally congratulates Joe Biden on election win	
t3_k0ss25	Twitter Users Mock Melania Trump's ‘Who Gives A F**k About Christmas’ Tree	
t3_k0srli	Newsmax CEO says Trump should concede election once all states have certified their results	
t3_k0sql6	Iran's president hopes Biden unravels Trump's Iran policies	
t3_k0spjx	Trump shares bizarre videos and tweets by actor Randy Quaid about voter fraud, Fox News	
t3_k0sng4	The three nuclear threats facing President-elect Biden	
t3_k0sjsl	A warning from Europe: Trump may be leaving, but right-wing populism is not	
t3_k0sg86	Schiff on possible Flynn pardon: Trump is 'acting like an organized crime figure'	
t3_k0sebi	How Black Americans Saved Biden and American Democracy	
t3_k0scsk	To Prevent 'Another Right-Wing Authoritarian' Even Worse Than Trump, Sanders Says Democrats Must Pursue Bold Working Class Agenda	
t3_k0sc9p	Trump plans to pardon former aide Michael Flynn: source	
t3_k0s9ff	Immigration advocates push Biden to not just bring back DACA but expand it	
t3_k0s958	New Poll: Majority of Americans Want the Senate to Reject Biden’s Corporate Nominees	
t3_k0s17r	Biden Says It Would Be 'Difficult' To Lose Sanders Or Warren From Senate For Admin	
t3_k0rx6m	Biden tamps down idea of Sanders or Warren in administration	
t3_k0rwl3	Biden Promises Bill Providing Pathway to Citizenship for 11 Million Illegal Immigrants in First 100 Days	
